,x,y,pts_crs,aoi,naip_id,r,r_max,r_min,r_diff,r_avg,r_entr,g,g_max,g_min,g_diff,g_avg,g_entr,b,b_max,b_min,b_diff,b_avg,b_entr,nir,nir_max,nir_min,nir_diff,nir_avg,nir_entr,year,month,day_in_year,iceplant
0,-120.48488084276656,34.497109887213966,EPSG:4326,point_conception,ca_m_3412037_nw_10_060_20200607,97,118,89,29,102.666664,4.1852303,92,105,85,20,95.0,4.0178246,78,89,72,17,80.111115,3.8404026,110,127,100,27,115.111115,4.07333,2020,6,159,1
8,-120.465339958536,34.46992049119658,EPSG:4326,point_conception,ca_m_3412037_nw_10_060_20200607,90,99,90,9,92.888885,3.495575,85,96,85,11,90.22222,3.345074,77,81,76,5,77.888885,2.9742157,100,113,96,17,103.0,4.3491917,2020,6,159,1
16,-120.49953931643918,34.49411682859048,EPSG:4326,point_conception,ca_m_3412037_nw_10_060_20200607,59,135,50,85,81.666664,4.487123,66,141,53,88,87.44444,4.582119,79,140,66,74,96.77778,4.582119,111,147,103,44,120.666664,4.487123,2020,6,159,1
18,-120.47140597637105,34.473210485095755,EPSG:4326,point_conception,ca_m_3412037_nw_10_060_20200607,96,118,93,25,100.111115,4.280226,92,112,92,20,98.666664,4.211261,77,97,77,20,84.55556,4.1852303,130,142,108,34,128.11111,4.461092,2020,6,159,1
19,-120.44669754571656,34.45565277734475,EPSG:4326,point_conception,ca_m_3412037_nw_10_060_20200607,111,134,104,30,118.44444,4.487123,99,121,95,26,107.333336,4.582119,79,95,79,16,85.55556,4.280226,161,167,135,32,155.88889,4.418157,2020,6,159,1
20,-120.43811127746277,34.45435336788937,EPSG:4326,point_conception,ca_m_3412037_nw_10_060_20200607,53,65,48,17,55.666668,4.582119,63,73,62,11,65.666664,4.1852303,59,62,51,11,57.444443,3.97489,101,121,93,28,106.111115,4.2372913,2020,6,159,1
21,-120.44442562863908,34.45285210010148,EPSG:4326,point_conception,ca_m_3412037_nw_10_060_20200607,34,52,29,23,39.444443,4.0642033,58,73,43,30,59.444443,4.090234,43,54,40,14,46.333332,3.6729972,167,174,152,22,166.44444,3.8094854,2020,6,159,1
25,-120.46998211314155,34.467804443843214,EPSG:4326,point_conception,ca_m_3412037_nw_10_060_20200607,105,112,94,18,103.333336,4.2372913,103,104,95,9,100.111115,3.8664331,84,88,76,12,81.77778,4.0867906,139,152,124,28,135.66667,4.582119,2020,6,159,1
28,-120.4733858976686,34.47491202351307,EPSG:4326,point_conception,ca_m_3412037_nw_10_060_20200607,77,85,66,19,77.333336,3.8312762,88,91,78,13,85.666664,3.676441,70,78,64,14,69.666664,3.9952378,129,136,110,26,124.111115,4.168326,2020,6,159,1
32,-120.45287712165457,34.454932558837896,EPSG:4326,point_conception,ca_m_3412037_nw_10_060_20200607,51,65,51,14,56.88889,3.8143718,52,63,52,11,57.77778,3.6040318,53,57,52,5,54.444443,2.822824,127,149,127,22,138.11111,4.2971306,2020,6,159,1
33,-120.50058202231146,34.49420308527623,EPSG:4326,point_conception,ca_m_3412037_nw_10_060_20200607,114,181,104,77,129.44444,4.7890153,121,181,107,74,133.44444,4.72005,132,184,118,66,140.44444,4.72005,137,173,130,43,143.11111,4.487123,2020,6,159,1
34,-120.49630474083406,34.502223606458045,EPSG:4326,point_conception,ca_m_3412037_nw_10_060_20200607,71,79,63,16,70.77778,3.9353986,74,81,70,11,74.44444,3.5350661,69,69,64,5,67.44444,3.410596,84,112,84,28,96.55556,4.375222,2020,6,159,1
36,-120.48119475314518,34.47478662770477,EPSG:4326,point_conception,ca_m_3412037_nw_10_060_20200607,22,24,15,9,20.444445,3.2331736,26,31,23,8,26.222221,3.2761085,44,47,37,10,42.0,3.5385098,49,49,44,5,46.77778,3.7454064,2020,6,159,1
45,-120.44609841315848,34.450669392992914,EPSG:4326,point_conception,ca_m_3412037_nw_10_060_20200607,85,90,81,9,85.666664,3.4435139,85,90,81,9,85.0,3.4435139,75,78,72,6,75.888885,3.1087031,101,114,84,30,100.22222,4.3491917,2020,6,159,1
46,-120.48744101005876,34.4895196489561,EPSG:4326,point_conception,ca_m_3412037_nw_10_060_20200607,82,88,77,11,81.888885,3.771437,79,83,72,11,76.77778,3.728502,67,69,64,5,66.22222,3.5645404,107,111,95,16,105.0,3.9614294,2020,6,159,1
49,-120.4678839846654,34.47045465609215,EPSG:4326,point_conception,ca_m_3412037_nw_10_060_20200607,104,105,84,21,93.666664,4.1422954,95,100,83,17,91.44444,3.952303,78,80,68,12,73.888885,4.116265,123,138,117,21,126.22222,4.418157,2020,6,159,1
53,-120.48511049889524,34.49598954249729,EPSG:4326,point_conception,ca_m_3412037_nw_10_060_20200607,93,107,93,14,99.111115,4.1852303,89,96,86,10,90.111115,3.7024715,75,79,72,7,76.0,3.184556,109,137,92,45,110.55556,4.280226,2020,6,159,1
54,-120.49518704364372,34.49743532039901,EPSG:4326,point_conception,ca_m_3412037_nw_10_060_20200607,79,89,61,28,76.111115,4.280226,84,88,71,17,78.888885,3.6595366,70,78,58,20,68.55556,4.047299,103,113,83,30,98.77778,4.375222,2020,6,159,1
57,-120.49469512904558,34.48854901195003,EPSG:4326,point_conception,ca_m_3412037_nw_10_060_20200607,50,70,38,32,52.22222,4.2541957,55,72,44,28,56.555557,4.418157,67,80,54,26,67.44444,4.047299,86,94,83,11,88.111115,3.6504104,2020,6,159,1
60,-120.46468422562316,34.47130240552811,EPSG:4326,point_conception,ca_m_3412037_nw_10_060_20200607,95,102,84,18,92.888885,4.1422954,94,98,84,14,89.888885,3.7159321,82,85,71,14,78.0,3.952303,107,114,97,17,105.888885,4.1852303,2020,6,159,1
61,-120.44356378950324,34.454348585509344,EPSG:4326,point_conception,ca_m_3412037_nw_10_060_20200607,49,54,45,9,48.22222,3.9783335,63,64,50,14,58.555557,4.2372913,44,46,40,6,43.666668,3.4535308,160,165,141,24,154.88889,4.3921266,2020,6,159,1
65,-120.46867517353628,34.48296044612695,EPSG:4326,point_conception,ca_m_3412037_nw_10_060_20200607,80,104,66,38,84.55556,4.487123,72,91,67,24,76.77778,4.3491917,64,78,58,20,66.0,4.047299,96,121,89,32,101.888885,4.375222,2020,6,159,1
75,-120.47080335140735,34.47218652338257,EPSG:4326,point_conception,ca_m_3412037_nw_10_060_20200607,83,92,78,14,84.333336,4.116265,81,88,73,15,81.77778,3.9783335,64,71,57,14,65.666664,4.1852303,143,154,134,20,141.77777,4.5560884,2020,6,159,1
77,-120.47206399453648,34.467420233463855,EPSG:4326,point_conception,ca_m_3412037_nw_10_060_20200607,91,95,87,8,90.77778,3.9614294,99,102,93,9,97.55556,3.2022564,74,82,66,16,74.22222,4.306257,140,162,122,40,142.11111,4.6510844,2020,6,159,1
83,-120.46835530762212,34.467824828952,EPSG:4326,point_conception,ca_m_3412037_nw_10_060_20200607,67,83,65,18,69.55556,4.280226,73,86,73,13,79.22222,3.417483,59,67,57,10,61.444443,3.9353986,122,147,119,28,127.77778,4.418157,2020,6,159,1
87,-120.4470686657023,34.45697491724491,EPSG:4326,point_conception,ca_m_3412037_nw_10_060_20200607,135,136,132,4,134.33333,2.9263945,102,105,99,6,101.77778,3.1811123,81,85,80,5,81.44444,2.8926804,150,155,141,14,148.66667,4.116265,2020,6,159,1
91,-120.50000343153708,34.4943264653616,EPSG:4326,point_conception,ca_m_3412037_nw_10_060_20200607,115,125,100,25,113.111115,4.2541957,118,127,107,20,119.22222,4.168326,123,128,115,13,122.111115,3.9262724,128,135,118,17,126.666664,3.676441,2020,6,159,1
92,-120.44729630559854,34.45679035939854,EPSG:4326,point_conception,ca_m_3412037_nw_10_060_20200607,52,68,47,21,53.333332,4.1852303,72,75,67,8,71.333336,4.116265,55,58,49,9,53.22222,3.676441,168,172,157,15,166.22223,4.0212684,2020,6,159,1
95,-120.482805877436,34.48681164164793,EPSG:4326,point_conception,ca_m_3412037_nw_10_060_20200607,105,136,85,51,105.0,4.582119,101,119,80,39,98.55556,4.418157,84,99,73,26,83.44444,4.3491917,120,133,103,30,119.666664,4.280226,2020,6,159,1
99,-120.46781186859792,34.47024761882527,EPSG:4326,point_conception,ca_m_3412037_nw_10_060_20200607,89,99,78,21,89.22222,3.9952378,86,94,81,13,86.77778,3.3745482,71,79,68,11,73.333336,3.7454064,106,110,100,10,103.22222,3.5350661,2020,6,159,1
100,-120.23248353958552,34.47664120112729,EPSG:4326,gaviota,ca_m_3412039_nw_10_060_20200522,132,134,129,5,131.55556,3.1887958,103,109,102,7,104.77778,3.5554142,91,94,88,6,91.77778,3.164208,166,167,159,8,163.66667,3.3711047,2020,5,143,1
101,-120.25196092598352,34.47559900733751,EPSG:4326,gaviota,ca_m_3412039_nw_10_060_20200522,95,138,69,69,99.0,4.582119,102,138,78,60,105.44444,4.3491917,78,109,69,40,84.77778,4.168326,145,153,131,22,144.44444,4.323161,2020,5,143,1
102,-120.20661829818638,34.47141719210704,EPSG:4326,gaviota,ca_m_3412039_nw_10_060_20200522,72,92,63,29,74.0,4.280226,88,101,76,25,86.0,4.306257,73,85,70,15,76.111115,4.0178246,171,174,165,9,170.11111,3.7159321,2020,5,143,1
103,-120.18653998643184,34.47714919622787,EPSG:4326,gaviota,ca_m_3412039_nw_10_060_20200522,117,128,105,23,118.111115,4.1852303,128,135,124,11,129.0,3.5385098,109,122,91,31,105.55556,3.9002419,157,168,140,28,153.77777,4.047299,2020,5,143,1
104,-120.24788776973348,34.468573360607486,EPSG:4326,gaviota,ca_m_3412039_nw_10_060_20200522,107,119,100,19,107.666664,4.1852303,112,125,106,19,113.888885,4.306257,108,116,104,12,109.0,3.9228287,119,126,109,17,116.0,4.211261,2020,5,143,1
105,-120.22712377552752,34.474599565925665,EPSG:4326,gaviota,ca_m_3412039_nw_10_060_20200522,53,58,52,6,54.11111,3.2930129,70,73,66,7,69.77778,3.6729972,63,66,58,8,61.444443,2.9178202,131,140,130,10,134.44444,3.8109283,2020,5,143,1
106,-120.1996538972457,34.47716392520324,EPSG:4326,gaviota,ca_m_3412039_nw_10_060_20200522,53,60,46,14,54.11111,3.483005,73,82,66,16,73.666664,3.6595366,67,72,63,9,67.55556,3.1887958,150,165,142,23,152.11111,4.116265,2020,5,143,1
107,-120.22915722117672,34.474726842699035,EPSG:4326,gaviota,ca_m_3412039_nw_10_060_20200522,42,47,36,11,40.666668,3.1936822,73,77,60,17,69.77778,3.6040318,56,58,50,8,54.77778,3.2626479,173,183,159,24,171.88889,4.116265,2020,5,143,1
108,-120.207805039906,34.47480308306009,EPSG:4326,gaviota,ca_m_3412039_nw_10_060_20200522,58,67,46,21,55.444443,4.2372913,72,77,61,16,69.333336,4.07333,69,73,61,12,65.888885,3.8664331,180,182,171,11,176.88889,4.004364,2020,5,143,1
109,-120.2111014302094,34.47289342960836,EPSG:4326,gaviota,ca_m_3412039_nw_10_060_20200522,92,106,73,33,88.44444,4.418157,110,115,101,14,107.77778,4.116265,93,98,79,19,87.333336,4.090234,159,168,156,12,161.55556,3.633506,2020,5,143,1
110,-120.18869291814116,34.47410505492942,EPSG:4326,gaviota,ca_m_3412039_nw_10_060_20200522,66,87,57,30,70.0,4.0993605,100,107,89,18,98.77778,4.418157,77,86,68,18,77.888885,4.1852303,180,182,173,9,178.0,3.8404026,2020,5,143,1
111,-120.1863854598875,34.47863840764044,EPSG:4326,gaviota,ca_m_3412039_nw_10_060_20200522,64,85,59,26,67.333336,4.418157,81,95,76,19,83.22222,4.090234,75,88,71,17,77.0,3.952303,152,155,143,12,150.44444,3.8798938,2020,5,143,1
112,-120.210821238917,34.47836597179379,EPSG:4326,gaviota,ca_m_3412039_nw_10_060_20200522,43,48,43,5,45.22222,3.332504,69,74,64,10,70.44444,3.5350661,60,63,58,5,60.88889,2.8497455,166,175,162,13,167.77777,3.8833375,2020,5,143,1
113,-120.22999059646531,34.47520007261674,EPSG:4326,gaviota,ca_m_3412039_nw_10_060_20200522,70,90,57,33,72.0,4.07333,99,114,82,32,100.55556,4.211261,69,83,67,16,74.22222,3.495575,164,164,155,9,160.33333,3.5780013,2020,5,143,1
115,-120.23333726516252,34.475708618458505,EPSG:4326,gaviota,ca_m_3412039_nw_10_060_20200522,96,103,91,12,97.55556,3.3133607,89,95,82,13,89.888885,3.6933453,84,84,76,8,81.0,3.2331736,140,145,134,11,139.0,3.7419627,2020,5,143,1
116,-120.22910108115896,34.47642388655162,EPSG:4326,gaviota,ca_m_3412039_nw_10_060_20200522,56,66,49,17,58.22222,3.5554142,75,90,69,21,80.44444,4.116265,67,72,61,11,65.55556,3.3711047,141,160,141,19,151.11111,4.0178246,2020,5,143,1
117,-120.19170390227114,34.47818750398998,EPSG:4326,gaviota,ca_m_3412039_nw_10_060_20200522,51,54,48,6,51.444443,3.6469667,66,73,66,7,67.888885,3.6209362,67,70,66,4,67.77778,3.2162693,106,122,102,20,111.333336,4.418157,2020,5,143,1
120,-120.22544850466132,34.4735176524556,EPSG:4326,gaviota,ca_m_3412039_nw_10_060_20200522,104,109,98,11,102.888885,3.8833375,113,119,103,16,110.888885,4.090234,104,106,99,7,102.888885,3.771437,125,133,107,26,121.0,4.323161,2020,5,143,1
121,-120.23234293225926,34.477141020236324,EPSG:4326,gaviota,ca_m_3412039_nw_10_060_20200522,121,124,115,9,120.666664,3.3845654,107,111,101,10,107.111115,3.4661007,95,99,87,12,92.333336,3.4140396,159,163,152,11,157.66667,3.6074753,2020,5,143,1
122,-120.19286905403658,34.473627795248305,EPSG:4326,gaviota,ca_m_3412039_nw_10_060_20200522,57,76,52,24,60.11111,4.5131536,78,94,73,21,81.111115,4.323161,69,84,66,18,72.55556,4.168326,169,170,164,6,167.33333,3.3485177,2020,5,143,1
123,-120.22431148268006,34.47649361837725,EPSG:4326,gaviota,ca_m_3412039_nw_10_060_20200522,102,110,97,13,103.55556,3.9262724,98,107,96,11,100.44444,3.6209362,83,89,80,9,84.77778,3.2626479,142,145,136,9,141.55556,3.9353986,2020,5,143,1
124,-120.19393477995574,34.47437162860851,EPSG:4326,gaviota,ca_m_3412039_nw_10_060_20200522,117,124,113,11,117.666664,4.1591997,123,130,114,16,120.888885,3.7454064,111,122,102,20,111.44444,4.3491917,132,133,119,14,126.666664,3.6455238,2020,5,143,1
125,-120.2462986101029,34.47182061602359,EPSG:4326,gaviota,ca_m_3412039_nw_10_060_20200522,91,96,84,12,89.55556,4.0438557,103,106,94,12,101.0,4.0212684,85,94,82,12,86.888885,3.8404026,104,107,95,12,102.333336,3.8404026,2020,5,143,1
126,-120.20282644482717,34.478188541301016,EPSG:4326,gaviota,ca_m_3412039_nw_10_060_20200522,55,67,52,15,57.333332,3.857307,80,94,72,22,79.55556,4.090234,72,72,69,3,70.666664,3.1936822,158,168,145,23,155.77777,4.5131536,2020,5,143,1
127,-120.25274899400344,34.47467021706377,EPSG:4326,gaviota,ca_m_3412039_nw_10_060_20200522,108,123,105,18,112.111115,4.3491917,99,117,92,25,102.44444,3.9488595,88,100,87,13,92.22222,3.771437,122,143,115,28,127.0,4.280226,2020,5,143,1
128,-120.19984293913906,34.475221159212346,EPSG:4326,gaviota,ca_m_3412039_nw_10_060_20200522,103,131,64,67,96.888885,4.582119,104,125,75,50,99.666664,4.418157,108,123,74,49,101.0,4.3491917,126,133,115,18,125.0,4.487123,2020,5,143,1
129,-120.20981088469075,34.478894573848834,EPSG:4326,gaviota,ca_m_3412039_nw_10_060_20200522,54,58,50,8,53.77778,4.004364,68,73,67,6,69.888885,3.7419627,66,68,64,4,66.22222,3.2022564,138,144,135,9,139.22223,4.07333,2020,5,143,1
130,-120.20235692803696,34.47562492100849,EPSG:4326,gaviota,ca_m_3412039_nw_10_060_20200522,45,64,35,29,48.0,4.1852303,62,81,46,35,63.333332,4.280226,59,70,53,17,61.11111,3.7193758,136,170,85,85,134.22223,4.5131536,2020,5,143,1
131,-120.20807119256786,34.47935781924584,EPSG:4326,gaviota,ca_m_3412039_nw_10_060_20200522,64,65,61,4,63.555557,2.9207118,81,83,80,3,81.44444,2.718055,75,77,71,6,74.44444,2.9018066,158,160,150,10,156.44444,3.45264,2020,5,143,1
132,-120.19580601817496,34.479536554305774,EPSG:4326,gaviota,ca_m_3412039_nw_10_060_20200522,91,114,68,46,91.888885,4.625054,96,111,76,35,95.0,4.6510844,95,108,79,29,92.77778,4.3491917,106,124,100,24,107.77778,4.1331687,2020,5,143,1
133,-120.18710312844256,34.47496627845037,EPSG:4326,gaviota,ca_m_3412039_nw_10_060_20200522,87,133,59,74,93.77778,4.582119,88,128,70,58,96.77778,4.582119,82,110,65,45,86.55556,4.375222,131,152,120,32,133.11111,4.444188,2020,5,143,1
134,-120.23132485362716,34.47454883396868,EPSG:4326,gaviota,ca_m_3412039_nw_10_060_20200522,108,115,108,7,111.0,3.5090356,109,109,104,5,106.666664,3.7193758,93,96,89,7,92.111115,3.2886784,138,140,134,6,137.0,3.3711047,2020,5,143,1
135,-120.2250412833887,34.47950118323129,EPSG:4326,gaviota,ca_m_3412039_nw_10_060_20200522,128,146,127,19,136.77777,4.0212684,109,117,104,13,111.77778,3.6209362,91,96,86,10,91.22222,3.7193758,174,177,172,5,174.11111,2.736402,2020,5,143,1
136,-120.2183153347034,34.47946176117894,EPSG:4326,gaviota,ca_m_3412039_nw_10_060_20200522,65,95,63,32,70.111115,4.0381727,80,103,77,26,83.44444,4.1852303,73,92,70,22,76.55556,4.0867906,139,140,131,9,136.88889,4.0867906,2020,5,143,1
137,-120.23755761424847,34.47725366564061,EPSG:4326,gaviota,ca_m_3412039_nw_10_060_20200522,94,98,81,17,90.333336,4.418157,100,107,81,26,97.44444,4.211261,93,96,78,18,89.333336,3.7974677,109,118,92,26,104.44444,4.306257,2020,5,143,1
138,-120.22816806883552,34.47935583979023,EPSG:4326,gaviota,ca_m_3412039_nw_10_060_20200522,114,134,75,59,103.111115,4.5131536,120,120,99,21,112.888885,4.168326,85,100,61,39,79.44444,4.1852303,175,183,165,18,176.0,3.9783335,2020,5,143,1
139,-120.19884802966186,34.4782163500313,EPSG:4326,gaviota,ca_m_3412039_nw_10_060_20200522,52,54,43,11,50.11111,3.7679935,68,72,60,12,66.666664,3.8404026,67,71,61,10,66.22222,3.3576438,105,116,93,23,107.55556,3.6074753,2020,5,143,1
140,-120.19780514223136,34.478543986245505,EPSG:4326,gaviota,ca_m_3412039_nw_10_060_20200522,48,54,47,7,50.555557,2.7673192,69,71,65,6,67.55556,2.9867857,66,69,64,5,65.44444,2.801128,136,138,129,9,134.66667,3.410596,2020,5,143,1
141,-120.2116789407069,34.472809259332806,EPSG:4326,gaviota,ca_m_3412039_nw_10_060_20200522,89,136,76,60,96.888885,4.7890153,89,129,78,51,95.44444,4.168326,88,117,78,39,90.77778,4.5560884,147,157,136,21,148.0,4.0438557,2020,5,143,1
142,-120.24814205388203,34.4761404290632,EPSG:4326,gaviota,ca_m_3412039_nw_10_060_20200522,121,124,100,24,114.44444,4.323161,113,116,98,18,108.111115,4.1852303,91,96,80,16,89.111115,4.047299,134,139,131,8,135.0,3.728502,2020,5,143,1
143,-120.19102824888682,34.47438053840472,EPSG:4326,gaviota,ca_m_3412039_nw_10_060_20200522,115,134,106,28,122.0,4.582119,118,130,111,19,121.0,4.1852303,109,119,103,16,111.0,4.1422954,134,144,125,19,136.44444,4.1852303,2020,5,143,1
144,-120.23135206320418,34.47906027038529,EPSG:4326,gaviota,ca_m_3412039_nw_10_060_20200522,66,73,62,11,65.333336,3.952303,90,90,81,9,86.77778,3.7848978,71,77,66,11,71.0,3.4140396,153,157,132,25,147.11111,4.306257,2020,5,143,1
146,-120.18820509021587,34.4750186953552,EPSG:4326,gaviota,ca_m_3412039_nw_10_060_20200522,68,85,43,42,63.444443,4.444188,93,107,59,48,84.333336,4.418157,77,86,59,27,73.666664,4.116265,145,161,118,43,142.33333,4.418157,2020,5,143,1
147,-120.2319280408886,34.47507091935262,EPSG:4326,gaviota,ca_m_3412039_nw_10_060_20200522,99,105,95,10,98.55556,4.047299,110,114,107,7,110.111115,3.561097,89,92,85,7,88.55556,3.4005787,153,153,147,6,149.11111,3.302139,2020,5,143,1
148,-120.21096590756764,34.47539453044553,EPSG:4326,gaviota,ca_m_3412039_nw_10_060_20200522,114,117,106,11,113.0,3.7883413,116,120,105,15,114.77778,3.7623107,89,99,81,18,90.77778,3.909368,165,170,153,17,162.22223,4.1591997,2020,5,143,1
149,-120.1858419406542,34.47615415913921,EPSG:4326,gaviota,ca_m_3412039_nw_10_060_20200522,68,74,67,7,69.22222,2.9143765,85,90,85,5,87.22222,3.069212,77,81,75,6,78.44444,3.4695444,139,141,133,8,137.77777,3.7024715,2020,5,143,1
151,-120.19658266110956,34.477212457695806,EPSG:4326,gaviota,ca_m_3412039_nw_10_060_20200522,56,71,50,21,59.666668,4.004364,72,85,67,18,75.55556,4.0212684,68,80,64,16,69.55556,3.3880088,124,130,116,14,122.55556,4.004364,2020,5,143,1
153,-120.22922436193468,34.475658654420734,EPSG:4326,gaviota,ca_m_3412039_nw_10_060_20200522,36,46,33,13,39.666668,3.6899016,61,76,52,24,66.44444,4.004364,49,57,47,10,52.666668,3.6074753,170,178,161,17,169.77777,4.0993605,2020,5,143,1
154,-120.21200598274972,34.47573738532381,EPSG:4326,gaviota,ca_m_3412039_nw_10_060_20200522,136,153,136,17,142.44444,4.116265,124,137,123,14,128.77777,3.8404026,106,124,102,22,111.111115,3.8664331,156,159,150,9,155.0,3.6469667,2020,5,143,1
156,-120.19705753633832,34.47160922069424,EPSG:4326,gaviota,ca_m_3412039_nw_10_060_20200522,92,93,83,10,87.44444,3.952303,117,124,109,15,114.77778,3.8833375,94,96,86,10,91.44444,3.4864488,140,148,135,13,142.44444,3.7848978,2020,5,143,1
157,-120.23420170364656,34.474846584471855,EPSG:4326,gaviota,ca_m_3412039_nw_10_060_20200522,80,95,80,15,90.0,4.168326,91,109,91,18,101.888885,4.0178246,74,84,74,10,79.55556,3.7974677,145,145,135,10,141.11111,3.8833375,2020,5,143,1
158,-120.20794286385112,34.47419505916428,EPSG:4326,gaviota,ca_m_3412039_nw_10_060_20200522,53,67,49,18,55.88889,4.280226,55,71,55,16,60.88889,4.3491917,61,70,60,10,64.666664,4.047299,106,150,98,52,124.666664,4.72005,2020,5,143,1
159,-120.22535824946377,34.478805260456205,EPSG:4326,gaviota,ca_m_3412039_nw_10_060_20200522,143,146,138,8,141.55556,3.52594,125,131,117,14,123.55556,3.5350661,101,101,93,8,97.666664,3.5124793,168,171,168,3,169.33333,2.4345095,2020,5,143,1
160,-120.23246366655908,34.478230896217326,EPSG:4326,gaviota,ca_m_3412039_nw_10_060_20200522,88,93,84,9,88.77778,3.6729972,97,101,96,5,98.77778,3.417483,77,81,74,7,78.0,3.2861254,141,150,131,19,142.66667,4.116265,2020,5,143,1
161,-120.185345412795,34.47635365251268,EPSG:4326,gaviota,ca_m_3412039_nw_10_060_20200522,81,94,81,13,86.0,4.1422954,90,103,90,13,98.22222,3.663871,83,97,83,14,87.888885,3.7679935,131,135,119,16,127.0,3.909368,2020,5,143,1
162,-120.2192105951857,34.47275920899072,EPSG:4326,gaviota,ca_m_3412039_nw_10_060_20200522,73,102,69,33,79.55556,4.2541957,88,111,82,29,92.333336,4.5131536,75,96,73,23,80.22222,4.112821,161,165,152,13,158.66667,3.6729972,2020,5,143,1
163,-120.20003009670192,34.47919537064945,EPSG:4326,gaviota,ca_m_3412039_nw_10_060_20200522,56,79,44,35,58.11111,4.1852303,80,94,61,33,77.22222,4.211261,66,82,59,23,69.77778,4.116265,149,163,138,25,150.88889,3.909368,2020,5,143,1
164,-120.18731066059463,34.47073071868807,EPSG:4326,gaviota,ca_m_3412039_nw_10_060_20200522,98,102,96,6,98.77778,3.6209362,112,120,110,10,114.22222,3.8504195,96,108,96,12,99.55556,3.3485177,135,143,127,16,133.66667,4.375222,2020,5,143,1
165,-120.20064250047966,34.4778734819115,EPSG:4326,gaviota,ca_m_3412039_nw_10_060_20200522,76,83,70,13,76.77778,4.461092,85,95,85,10,88.666664,3.9228287,86,92,80,12,84.55556,4.0212684,125,141,125,16,131.11111,4.1852303,2020,5,143,1
166,-120.19683766906242,34.47173939021917,EPSG:4326,gaviota,ca_m_3412039_nw_10_060_20200522,79,89,75,14,80.55556,3.5780013,115,121,113,8,116.44444,3.3711047,79,98,79,19,85.55556,3.8143718,181,185,175,10,180.22223,3.952303,2020,5,143,1
168,-120.23537445335698,34.47394284473805,EPSG:4326,gaviota,ca_m_3412039_nw_10_060_20200522,132,138,126,12,132.55556,3.4435139,128,133,127,6,129.88889,3.2331736,101,107,95,12,102.666664,3.6899016,148,152,145,7,148.77777,3.2535214,2020,5,143,1
170,-120.2094541263138,34.47490026625474,EPSG:4326,gaviota,ca_m_3412039_nw_10_060_20200522,73,93,63,30,75.111115,4.3921266,99,116,93,23,101.77778,4.375222,82,95,77,18,83.22222,4.047299,165,169,159,10,164.11111,3.7419627,2020,5,143,1
171,-120.19322089058488,34.479109386334834,EPSG:4326,gaviota,ca_m_3412039_nw_10_060_20200522,59,62,53,9,56.666668,3.0417385,77,79,71,8,75.888885,3.207143,66,70,66,4,67.55556,2.8313982,159,163,153,10,156.88889,3.314709,2020,5,143,1
172,-120.19026289810834,34.478311210658234,EPSG:4326,gaviota,ca_m_3412039_nw_10_060_20200522,87,99,59,40,86.0,4.5560884,89,103,72,31,90.22222,4.211261,86,91,71,20,84.0,4.2541957,121,129,108,21,119.22222,4.487123,2020,5,143,1
173,-120.19032272823613,34.47672245951584,EPSG:4326,gaviota,ca_m_3412039_nw_10_060_20200522,35,50,35,15,40.555557,4.2541957,47,58,44,14,52.0,4.280226,52,65,52,13,58.0,3.9783335,81,136,54,82,90.333336,4.582119,2020,5,143,1
176,-120.2363964363607,34.470877623740925,EPSG:4326,gaviota,ca_m_3412039_nw_10_060_20200522,92,95,83,12,90.55556,3.5645404,95,99,88,11,94.111115,3.5780013,81,83,80,3,81.333336,2.888346,113,123,96,27,110.111115,4.116265,2020,5,143,1
177,-120.19457551955684,34.476885122883175,EPSG:4326,gaviota,ca_m_3412039_nw_10_060_20200522,79,93,70,23,82.44444,4.582119,88,103,84,19,93.22222,4.5131536,82,95,76,19,85.55556,4.280226,140,144,135,9,139.55556,3.6595366,2020,5,143,1
178,-120.18936174586491,34.47850141096962,EPSG:4326,gaviota,ca_m_3412039_nw_10_060_20200522,91,105,69,36,90.0,4.487123,124,136,81,55,114.888885,4.280226,85,91,76,15,83.22222,4.2372913,186,193,156,37,180.0,4.2541957,2020,5,143,1
179,-120.20308165056456,34.479151710715065,EPSG:4326,gaviota,ca_m_3412039_nw_10_060_20200522,53,55,48,7,51.666668,3.771437,70,72,63,9,68.888885,3.676441,59,64,55,9,60.333332,3.4661007,141,149,122,27,139.88889,4.3491917,2020,5,143,1
182,-120.22159921759425,34.479109227478936,EPSG:4326,gaviota,ca_m_3412039_nw_10_060_20200522,133,141,129,12,134.22223,3.3006961,120,127,120,7,122.77778,2.8566327,103,104,93,11,99.111115,3.250078,157,160,151,9,156.55556,3.2761085,2020,5,143,1
183,-120.23008985994096,34.47772816568464,EPSG:4326,gaviota,ca_m_3412039_nw_10_060_20200522,55,62,53,9,56.666668,3.7193758,77,84,72,12,78.111115,3.8798938,63,66,60,6,63.22222,2.9052503,143,150,139,11,145.11111,3.9228287,2020,5,143,1
184,-120.20916902000783,34.478360680616454,EPSG:4326,gaviota,ca_m_3412039_nw_10_060_20200522,51,67,51,16,57.444443,3.5905712,70,81,67,14,73.111115,3.633506,68,76,68,8,70.0,3.4695444,134,147,122,25,137.55556,3.952303,2020,5,143,1
185,-120.20480235761708,34.47142973489272,EPSG:4326,gaviota,ca_m_3412039_nw_10_060_20200522,63,74,50,24,63.0,4.0993605,93,102,77,25,92.22222,4.1422954,77,80,71,9,76.666664,3.4921312,160,168,139,29,158.77777,4.116265,2020,5,143,1
186,-120.25231047367711,34.47589353263589,EPSG:4326,gaviota,ca_m_3412039_nw_10_060_20200522,55,66,49,17,58.555557,4.047299,74,97,69,28,83.0,4.3921266,58,70,56,14,63.0,3.8143718,171,179,164,15,170.88889,4.1852303,2020,5,143,1
187,-120.23306904700635,34.47908295426621,EPSG:4326,gaviota,ca_m_3412039_nw_10_060_20200522,59,71,58,13,62.22222,3.5645404,81,93,81,12,85.77778,3.8109283,65,74,65,9,69.55556,3.758867,152,158,138,20,148.0,4.375222,2020,5,143,1
188,-120.21579713956488,34.47662434357482,EPSG:4326,gaviota,ca_m_3412039_nw_10_060_20200522,101,112,93,19,100.888885,3.8404026,110,119,109,10,112.666664,3.8143718,90,94,82,12,87.666664,3.633506,156,169,151,18,160.66667,4.090234,2020,5,143,1
189,-120.25170210621992,34.47393271626325,EPSG:4326,gaviota,ca_m_3412039_nw_10_060_20200522,141,162,133,29,143.88889,4.582119,114,141,111,30,125.111115,4.418157,102,118,96,22,104.666664,4.211261,176,181,171,10,175.66667,3.495575,2020,5,143,1
190,-120.23366272444416,34.476532697926714,EPSG:4326,gaviota,ca_m_3412039_nw_10_060_20200522,96,98,88,10,92.44444,3.952303,104,107,98,9,102.888885,4.280226,91,94,87,7,90.0,3.4738786,122,134,112,22,123.111115,3.952303,2020,5,143,1
191,-120.19660826389752,34.47781340065955,EPSG:4326,gaviota,ca_m_3412039_nw_10_060_20200522,51,59,35,24,48.11111,4.1422954,66,71,50,21,62.0,4.1422954,66,76,57,19,65.77778,3.952303,107,107,85,22,95.888885,4.1591997,2020,5,143,1
196,-120.23205976065935,34.478594940565706,EPSG:4326,gaviota,ca_m_3412039_nw_10_060_20200522,122,156,74,82,127.333336,4.5560884,116,143,95,48,125.111115,4.444188,94,126,75,51,104.55556,4.582119,158,162,147,15,155.44444,4.090234,2020,5,143,1
197,-120.23516882842353,34.476215237586395,EPSG:4326,gaviota,ca_m_3412039_nw_10_060_20200522,133,137,105,32,126.77778,4.582119,124,126,108,18,119.666664,4.090234,100,101,79,22,93.55556,4.1422954,151,151,142,9,147.77777,3.5554142,2020,5,143,1
198,-120.23488943493854,34.478545454388154,EPSG:4326,gaviota,ca_m_3412039_nw_10_060_20200522,101,114,94,20,103.22222,3.952303,96,105,96,9,98.666664,3.8143718,86,92,81,11,87.666664,3.4400702,124,138,114,24,125.77778,4.2372913,2020,5,143,1
199,-120.1985393474572,34.478658184457814,EPSG:4326,gaviota,ca_m_3412039_nw_10_060_20200522,59,61,56,5,59.333332,2.9481852,79,80,74,6,77.333336,2.6168182,71,76,70,6,72.22222,2.968533,141,143,134,9,138.66667,3.1256075,2020,5,143,1
200,-120.0248992117927,34.461549995110644,EPSG:4326,capitan,ca_m_3412040_ne_10_060_20200522,51,66,51,15,58.333332,4.306257,75,89,75,14,82.0,4.07333,82,89,80,9,84.888885,3.5765584,138,159,138,21,146.88889,4.375222,2020,5,143,1
202,-120.01377104270829,34.46471813778117,EPSG:4326,capitan,ca_m_3412040_ne_10_060_20200522,122,124,111,13,116.55556,3.6074753,133,136,127,9,129.33333,3.4231658,115,115,109,6,112.77778,3.302139,148,149,142,7,144.55556,3.758867,2020,5,143,1
204,-120.00059805292406,34.45931693679196,EPSG:4326,capitan,ca_m_3412040_ne_10_060_20200522,63,71,51,20,60.88889,4.116265,80,88,67,21,78.888885,4.280226,79,83,73,10,78.333336,3.5033529,149,158,131,27,149.44444,4.306257,2020,5,143,1
205,-120.02181995815737,34.46129106915932,EPSG:4326,capitan,ca_m_3412040_ne_10_060_20200522,35,55,33,22,41.0,4.090234,60,81,57,24,68.55556,4.1422954,76,80,71,9,76.44444,3.3542004,139,154,138,16,146.11111,4.1422954,2020,5,143,1
206,-119.99850061138876,34.46337031843338,EPSG:4326,capitan,ca_m_3412040_ne_10_060_20200522,147,161,123,38,145.88889,4.418157,169,173,149,24,165.22223,4.228165,90,97,82,15,89.888885,3.8833375,199,202,194,8,197.88889,3.3845654,2020,5,143,1
207,-120.0051365481532,34.460212508640346,EPSG:4326,capitan,ca_m_3412040_ne_10_060_20200522,56,65,48,17,56.666668,4.2541957,88,91,84,7,87.77778,3.6595366,79,83,76,7,79.44444,3.6040318,150,154,147,7,150.44444,2.995912,2020,5,143,1
208,-120.05137363072592,34.46626990672251,EPSG:4326,capitan,ca_m_3412040_ne_10_060_20200522,118,151,107,44,126.111115,4.444188,127,154,116,38,133.55556,4.375222,126,147,111,36,128.88889,4.090234,135,140,133,7,136.66667,3.5124793,2020,5,143,1
210,-120.02901714285504,34.46198013856973,EPSG:4326,capitan,ca_m_3412040_ne_10_060_20200522,27,41,23,18,29.666666,4.1852303,44,65,42,23,51.666668,4.5560884,70,74,66,8,69.888885,3.857307,83,127,61,66,90.888885,4.72005,2020,5,143,1
211,-120.00312798756516,34.459595369357416,EPSG:4326,capitan,ca_m_3412040_ne_10_060_20200522,136,154,85,69,129.88889,4.72005,138,149,100,49,131.33333,4.582119,110,119,87,32,106.77778,4.444188,183,187,170,17,180.88889,3.9002419,2020,5,143,1
213,-120.02257999302152,34.46838372509175,EPSG:4326,capitan,ca_m_3412040_ne_10_060_20200522,54,61,46,15,53.22222,3.909368,95,101,84,17,92.77778,4.1422954,79,83,76,7,78.666664,3.2331736,189,193,184,9,188.55556,3.3576438,2020,5,143,1
214,-119.99951354666106,34.46717562629525,EPSG:4326,capitan,ca_m_3412040_ne_10_060_20200522,43,52,42,10,46.22222,3.9917943,91,96,86,10,91.333336,3.952303,67,70,65,5,67.666664,3.302139,201,201,198,3,199.66667,3.2466342,2020,5,143,1
215,-120.02392791433752,34.46279188848316,EPSG:4326,capitan,ca_m_3412040_ne_10_060_20200522,58,113,40,73,66.77778,4.444188,71,114,57,57,76.888885,4.444188,83,112,72,40,85.77778,4.1852303,104,130,84,46,107.22222,4.487123,2020,5,143,1
216,-120.04322567088576,34.46697072099102,EPSG:4326,capitan,ca_m_3412040_ne_10_060_20200522,61,74,55,19,63.77778,4.228165,86,100,86,14,92.111115,4.0212684,86,94,82,12,85.888885,3.6300623,171,181,162,19,171.22223,4.2372913,2020,5,143,1
217,-120.05437982059276,34.47010128252109,EPSG:4326,capitan,ca_m_3412040_ne_10_060_20200522,99,103,89,14,95.666664,4.004364,116,117,104,13,113.0,3.952303,94,106,92,14,97.22222,3.5350661,149,155,134,21,145.66667,3.8833375,2020,5,143,1
218,-120.04653516140836,34.462929601027575,EPSG:4326,capitan,ca_m_3412040_ne_10_060_20200522,106,117,101,16,108.55556,3.7454064,125,126,117,9,123.111115,3.219713,109,110,105,5,107.888885,3.2746656,135,142,126,16,134.55556,3.7974677,2020,5,143,1
219,-120.00037308601458,34.458305464174984,EPSG:4326,capitan,ca_m_3412040_ne_10_060_20200522,68,78,60,18,67.666664,3.857307,97,109,90,19,97.111115,3.6243796,86,94,82,12,86.77778,3.6469667,126,136,116,20,126.111115,4.280226,2020,5,143,1
220,-120.00349657498616,34.46188672611923,EPSG:4326,capitan,ca_m_3412040_ne_10_060_20200522,105,116,95,21,106.55556,4.280226,125,131,123,8,126.44444,3.8833375,91,94,88,6,92.0,3.2761085,189,190,188,2,188.88889,2.4302697,2020,5,143,1
221,-120.03599767623706,34.47156571010218,EPSG:4326,capitan,ca_m_3412040_ne_10_060_20200522,55,79,53,26,62.444443,4.0438557,85,114,82,32,92.888885,4.2372913,78,90,73,17,80.0,3.7193758,174,177,170,7,173.77777,2.4543524,2020,5,143,1
222,-120.01640180856798,34.46822213707048,EPSG:4326,capitan,ca_m_3412040_ne_10_060_20200522,107,122,95,27,110.55556,4.418157,122,132,112,20,124.333336,4.0212684,114,120,108,12,115.0,3.7974677,128,136,114,22,126.888885,3.8833375,2020,5,143,1
223,-120.02470253873378,34.46561769787942,EPSG:4326,capitan,ca_m_3412040_ne_10_060_20200522,86,98,77,21,87.888885,4.2372913,119,136,113,23,122.77778,4.3921266,101,108,97,11,102.111115,3.8798938,180,185,174,11,179.88889,3.7623107,2020,5,143,1
224,-119.99721912564392,34.461959692139466,EPSG:4326,capitan,ca_m_3412040_ne_10_060_20200522,110,114,98,16,107.0,4.418157,130,133,125,8,128.33333,4.047299,100,100,96,4,97.77778,3.133843,188,191,185,6,188.0,3.2726648,2020,5,143,1
225,-120.04285728584355,34.466307387858066,EPSG:4326,capitan,ca_m_3412040_ne_10_060_20200522,125,154,100,54,127.888885,4.487123,132,148,118,30,131.11111,4.280226,114,136,108,28,119.111115,3.8143718,145,145,137,8,142.77777,3.633506,2020,5,143,1
226,-120.04376310896676,34.466729536398034,EPSG:4326,capitan,ca_m_3412040_ne_10_060_20200522,61,105,57,48,70.888885,4.228165,90,112,90,22,95.888885,3.97489,82,99,79,20,85.22222,3.7144892,192,194,181,13,189.0,3.8143718,2020,5,143,1
227,-120.02264981243502,34.46200897834572,EPSG:4326,capitan,ca_m_3412040_ne_10_060_20200522,83,114,63,51,88.0,4.582119,111,125,94,31,111.111115,4.2541957,98,114,86,28,98.888885,4.280226,152,171,100,71,143.88889,4.6510844,2020,5,143,1
228,-120.0071856373468,34.46810481229617,EPSG:4326,capitan,ca_m_3412040_ne_10_060_20200522,144,165,135,30,149.0,4.090234,132,149,126,23,135.0,4.0438557,105,119,102,17,109.55556,4.1422954,165,168,160,8,164.11111,3.4435139,2020,5,143,1
229,-120.0067058013718,34.469472176336225,EPSG:4326,capitan,ca_m_3412040_ne_10_060_20200522,52,77,44,33,60.88889,4.5560884,71,94,64,30,83.111115,4.280226,76,93,76,17,84.888885,3.8404026,138,150,135,15,142.11111,4.116265,2020,5,143,1
230,-120.02334061319966,34.45928918651348,EPSG:4326,capitan,ca_m_3412040_ne_10_060_20200522,71,88,60,28,70.77778,4.3491917,101,122,93,29,104.22222,4.3491917,94,100,85,15,91.55556,3.6595366,181,189,181,8,184.44444,3.4864488,2020,5,143,1
231,-120.044921033326,34.46611395951931,EPSG:4326,capitan,ca_m_3412040_ne_10_060_20200522,42,66,35,31,48.88889,4.5131536,59,81,52,29,66.333336,4.3491917,73,85,72,13,77.333336,4.2541957,99,142,91,51,111.666664,4.582119,2020,5,143,1
232,-119.99853878260872,34.45720036531515,EPSG:4326,capitan,ca_m_3412040_ne_10_060_20200522,48,59,48,11,51.555557,4.090234,82,92,82,10,85.55556,3.758867,75,83,75,8,77.22222,3.6209362,145,152,144,8,148.55556,3.7848978,2020,5,143,1
233,-120.02278413431728,34.46962180567193,EPSG:4326,capitan,ca_m_3412040_ne_10_060_20200522,68,108,63,45,77.77778,4.487123,109,143,99,44,116.55556,4.5131536,92,114,85,29,95.55556,4.047299,193,198,185,13,192.22223,3.7883413,2020,5,143,1
234,-120.032130737305,34.470303594094545,EPSG:4326,capitan,ca_m_3412040_ne_10_060_20200522,102,103,78,25,95.22222,4.07333,133,133,105,28,122.111115,3.9228287,115,120,97,23,110.888885,4.0212684,135,148,118,30,133.11111,4.444188,2020,5,143,1
235,-120.05396382066029,34.467446541322374,EPSG:4326,capitan,ca_m_3412040_ne_10_060_20200522,95,110,95,15,101.666664,4.047299,113,123,113,10,117.333336,3.6209362,105,116,101,15,107.55556,3.7159321,131,144,118,26,131.66667,4.2541957,2020,5,143,1
236,-120.01998850379944,34.467806727920056,EPSG:4326,capitan,ca_m_3412040_ne_10_060_20200522,83,89,72,17,81.22222,4.461092,104,112,99,13,104.55556,4.306257,99,103,92,11,98.0,3.952303,151,154,149,5,151.66667,3.1536388,2020,5,143,1
237,-120.01268993155296,34.46628715978258,EPSG:4326,capitan,ca_m_3412040_ne_10_060_20200522,105,115,76,39,97.333336,4.5560884,124,133,103,30,117.0,4.3921266,110,114,95,19,104.888885,4.211261,158,170,146,24,158.77777,4.3491917,2020,5,143,1
239,-120.03086158090626,34.46576217018098,EPSG:4326,capitan,ca_m_3412040_ne_10_060_20200522,128,132,128,4,129.66667,3.4695444,117,120,112,8,116.333336,3.663871,110,113,110,3,111.44444,2.618819,147,150,146,4,148.33333,2.886903,2020,5,143,1
241,-120.02712827320106,34.468656771313945,EPSG:4326,capitan,ca_m_3412040_ne_10_060_20200522,142,151,124,27,141.44444,3.5949054,140,146,133,13,139.11111,3.5124793,127,135,110,25,123.55556,4.0303946,162,168,156,12,161.66667,3.8404026,2020,5,143,1
242,-120.06290505077015,34.4633027001983,EPSG:4326,capitan,ca_m_3412040_ne_10_060_20200522,69,85,69,16,76.333336,3.7883413,102,108,100,8,102.888885,3.4695444,93,104,91,13,97.111115,3.6209362,135,147,121,26,135.0,4.1852303,2020,5,143,1
243,-120.02711497625964,34.460013886741145,EPSG:4326,capitan,ca_m_3412040_ne_10_060_20200522,101,113,97,16,102.111115,3.8664331,127,137,119,18,126.22222,4.116265,103,121,98,23,108.0,4.1422954,145,159,121,38,141.0,4.582119,2020,5,143,1
244,-120.06231137767432,34.46850213439886,EPSG:4326,capitan,ca_m_3412040_ne_10_060_20200522,108,155,77,78,112.111115,4.582119,113,149,94,55,117.111115,4.72005,108,146,94,52,115.333336,4.72005,141,148,127,21,138.88889,4.487123,2020,5,143,1
245,-120.02642299239024,34.46497814324935,EPSG:4326,capitan,ca_m_3412040_ne_10_060_20200522,134,149,68,81,115.55556,4.582119,126,142,82,60,115.55556,4.487123,121,130,91,39,110.888885,4.2541957,159,171,138,33,158.22223,4.280226,2020,5,143,1
246,-120.06356045461514,34.462301675843456,EPSG:4326,capitan,ca_m_3412040_ne_10_060_20200522,118,137,93,44,115.55556,4.625054,132,147,114,33,129.88889,4.2372913,124,137,101,36,118.111115,4.487123,143,147,141,6,143.22223,3.771437,2020,5,143,1
247,-120.01090370162036,34.46711960737968,EPSG:4326,capitan,ca_m_3412040_ne_10_060_20200522,50,78,43,35,60.666668,4.444188,78,98,73,25,86.111115,4.2971306,83,95,80,15,87.44444,4.0438557,108,115,98,17,107.22222,4.047299,2020,5,143,1
248,-119.9982434129321,34.463623595283885,EPSG:4326,capitan,ca_m_3412040_ne_10_060_20200522,51,73,44,29,59.444443,4.6510844,84,111,79,32,95.0,4.3491917,77,85,73,12,79.55556,3.9917943,184,192,184,8,187.44444,4.090234,2020,5,143,1
249,-120.0524215425688,34.46506749396704,EPSG:4326,capitan,ca_m_3412040_ne_10_060_20200522,42,48,41,7,44.666668,2.99536,90,95,78,17,87.666664,3.758867,76,80,76,4,78.333336,2.6505322,188,190,186,4,187.77777,3.4005787,2020,5,143,1
250,-120.04682232741752,34.464786214467054,EPSG:4326,capitan,ca_m_3412040_ne_10_060_20200522,57,77,53,24,60.77778,4.375222,98,111,87,24,96.111115,4.211261,81,89,79,10,83.77778,3.5519705,175,176,165,11,171.66667,3.9353986,2020,5,143,1
251,-120.05479377487988,34.468542829485045,EPSG:4326,capitan,ca_m_3412040_ne_10_060_20200522,104,117,95,22,105.44444,4.090234,115,125,108,17,116.44444,3.6864579,107,114,107,7,111.22222,3.5385098,115,125,114,11,118.111115,3.6595366,2020,5,143,1
252,-120.02482860899802,34.46592904524715,EPSG:4326,capitan,ca_m_3412040_ne_10_060_20200522,118,137,73,64,107.333336,4.7890153,132,146,99,47,122.44444,4.582119,121,132,91,41,112.333336,4.5560884,161,172,157,15,163.55556,4.116265,2020,5,143,1
253,-120.01257114340866,34.465040336640314,EPSG:4326,capitan,ca_m_3412040_ne_10_060_20200522,130,132,124,8,128.0,3.909368,140,143,134,9,137.55556,3.3401875,124,127,118,9,123.111115,3.3316133,149,152,141,11,147.22223,3.7419627,2020,5,143,1
254,-120.02332867844147,34.4621985919867,EPSG:4326,capitan,ca_m_3412040_ne_10_060_20200522,51,55,50,5,52.555557,3.758867,93,98,76,22,89.111115,4.444188,83,83,80,3,81.44444,2.8792198,163,167,148,19,159.22223,4.211261,2020,5,143,1
255,-120.05332156921584,34.467512174026965,EPSG:4326,capitan,ca_m_3412040_ne_10_060_20200522,114,126,102,24,115.0,4.375222,126,137,117,20,127.44444,3.952303,113,123,107,16,114.666664,4.0212684,157,161,148,13,155.77777,4.1422954,2020,5,143,1
256,-120.04312708206054,34.46717385283253,EPSG:4326,capitan,ca_m_3412040_ne_10_060_20200522,81,146,56,90,89.77778,4.5560884,96,148,91,57,111.44444,4.3921266,88,135,81,54,99.55556,4.6510844,166,175,147,28,163.44444,4.2372913,2020,5,143,1
257,-120.02090799853084,34.460495435123434,EPSG:4326,capitan,ca_m_3412040_ne_10_060_20200522,52,61,50,11,53.666668,3.836959,72,86,71,15,77.55556,3.6899016,85,86,83,3,85.0,3.0531983,132,145,132,13,138.88889,4.090234,2020,5,143,1
258,-120.0624265471756,34.468569805419364,EPSG:4326,capitan,ca_m_3412040_ne_10_060_20200522,116,138,109,29,121.22222,3.8278327,120,131,117,14,122.888885,3.8538632,114,127,114,13,117.22222,3.5090356,133,134,124,10,130.44444,3.4695444,2020,5,143,1
259,-120.05326672414996,34.465358307631945,EPSG:4326,capitan,ca_m_3412040_ne_10_060_20200522,71,80,67,13,73.44444,4.250752,94,101,90,11,95.55556,3.8833375,87,94,87,7,89.77778,3.7848978,145,151,120,31,141.55556,4.211261,2020,5,143,1
260,-120.0433681603257,34.4657086083475,EPSG:4326,capitan,ca_m_3412040_ne_10_060_20200522,70,75,59,16,68.888885,3.9783335,88,90,82,8,86.111115,3.9783335,83,85,79,6,82.333336,3.1811123,165,165,156,9,161.88889,3.8143718,2020,5,143,1
262,-120.00367180623866,34.462464307526695,EPSG:4326,capitan,ca_m_3412040_ne_10_060_20200522,58,104,55,49,71.333336,4.625054,81,107,77,30,89.111115,4.5560884,77,93,75,18,81.44444,4.2541957,148,158,145,13,151.66667,4.306257,2020,5,143,1
263,-120.00034781120311,34.464118788918924,EPSG:4326,capitan,ca_m_3412040_ne_10_060_20200522,82,119,50,69,81.55556,4.487123,108,121,96,25,106.44444,4.487123,87,106,77,29,89.44444,4.2541957,176,194,122,72,165.22223,4.5560884,2020,5,143,1
264,-120.06245836741306,34.47064199252835,EPSG:4326,capitan,ca_m_3412040_ne_10_060_20200522,41,47,33,14,39.88889,3.7024715,70,80,49,31,68.333336,4.1852303,70,74,66,8,70.22222,3.4435139,158,172,135,37,155.33333,4.3921266,2020,5,143,1
266,-119.99740143227343,34.46306747120487,EPSG:4326,capitan,ca_m_3412040_ne_10_060_20200522,62,66,56,10,61.555557,3.8664331,94,97,88,9,92.55556,3.5949054,78,83,76,7,79.77778,3.219713,146,151,138,13,145.44444,3.8312762,2020,5,143,1
267,-120.0221285137894,34.46069285638585,EPSG:4326,capitan,ca_m_3412040_ne_10_060_20200522,21,34,19,15,25.333334,4.375222,38,61,38,23,47.666668,4.487123,65,73,64,9,67.55556,3.5090356,82,110,66,44,93.55556,4.487123,2020,5,143,1
268,-120.04600640233409,34.46700014854041,EPSG:4326,capitan,ca_m_3412040_ne_10_060_20200522,115,131,97,34,118.22222,4.211261,121,128,111,17,121.666664,3.4695444,110,121,101,20,112.111115,3.5814447,146,149,135,14,141.11111,4.211261,2020,5,143,1
270,-120.02913498002302,34.46602305294851,EPSG:4326,capitan,ca_m_3412040_ne_10_060_20200522,143,149,134,15,142.66667,4.116265,140,142,136,6,140.33333,3.1078124,120,122,118,4,120.0,3.2795522,160,163,152,11,158.77777,3.7848978,2020,5,143,1
271,-120.0227531183198,34.458182379744564,EPSG:4326,capitan,ca_m_3412040_ne_10_060_20200522,48,56,47,9,50.11111,2.803367,85,96,85,11,91.333336,3.5216055,80,86,80,6,82.77778,2.7109237,182,186,182,4,184.33333,3.0137072,2020,5,143,1
272,-120.05392847596612,34.469565781432465,EPSG:4326,capitan,ca_m_3412040_ne_10_060_20200522,59,62,53,9,58.77778,3.8109283,109,109,99,10,103.44444,3.9952378,85,85,80,5,82.44444,3.3006961,189,189,184,5,187.22223,3.250078,2020,5,143,1
273,-119.99700688032532,34.46205182241907,EPSG:4326,capitan,ca_m_3412040_ne_10_060_20200522,58,59,48,11,55.0,3.7454064,103,103,89,14,97.77778,3.9488595,79,79,74,5,77.22222,3.3155997,185,185,178,7,182.0,3.8404026,2020,5,143,1
274,-120.02865141144812,34.46584903877037,EPSG:4326,capitan,ca_m_3412040_ne_10_060_20200522,138,143,127,16,134.88889,4.487123,146,151,133,18,142.22223,4.280226,121,125,109,16,118.44444,4.280226,163,165,155,10,161.0,3.7454064,2020,5,143,1
275,-120.026154465196,34.46076930929652,EPSG:4326,capitan,ca_m_3412040_ne_10_060_20200522,85,89,65,24,74.888885,4.280226,91,98,76,22,84.55556,4.047299,92,97,85,12,91.0,3.7024715,116,122,87,35,107.77778,4.582119,2020,5,143,1
276,-120.00151923666374,34.46276843109554,EPSG:4326,capitan,ca_m_3412040_ne_10_060_20200522,136,136,131,5,133.66667,3.5554142,119,122,112,10,117.77778,3.6040318,99,100,97,3,98.666664,2.939855,156,159,155,4,157.22223,2.2076154,2020,5,143,1
277,-120.01023970580312,34.46962363777763,EPSG:4326,capitan,ca_m_3412040_ne_10_060_20200522,116,124,115,9,118.77778,3.7454064,124,130,123,7,126.44444,3.9614294,108,114,104,10,109.55556,3.069212,149,159,130,29,146.88889,4.1852303,2020,5,143,1
278,-120.03095962161368,34.46299546961863,EPSG:4326,capitan,ca_m_3412040_ne_10_060_20200522,79,81,70,11,74.888885,4.211261,110,112,104,8,108.111115,4.090234,92,99,89,10,92.44444,3.909368,150,154,139,15,148.55556,4.323161,2020,5,143,1
279,-120.0237195539786,34.46038550068163,EPSG:4326,capitan,ca_m_3412040_ne_10_060_20200522,62,75,60,15,66.111115,3.8798938,94,99,84,15,91.888885,3.4661007,85,92,85,7,88.0,3.1776688,146,149,129,20,140.33333,4.280226,2020,5,143,1
280,-120.01512393956844,34.467065978353936,EPSG:4326,capitan,ca_m_3412040_ne_10_060_20200522,141,148,131,17,140.11111,4.168326,154,155,145,10,150.55556,4.0212684,138,138,130,8,134.77777,3.7545328,156,156,142,14,151.22223,4.090234,2020,5,143,1
281,-120.03973513499466,34.47132103912543,EPSG:4326,capitan,ca_m_3412040_ne_10_060_20200522,119,127,103,24,114.77778,4.323161,117,121,102,19,111.55556,3.9488595,105,111,99,12,103.77778,3.909368,142,149,139,10,142.44444,3.5780013,2020,5,143,1
282,-120.00627732092124,34.462457889750496,EPSG:4326,capitan,ca_m_3412040_ne_10_060_20200522,166,173,162,11,167.0,3.3407397,177,181,176,5,178.11111,2.7504148,132,137,129,8,132.55556,3.3055828,203,204,202,2,203.11111,1.4866326,2020,5,143,1
283,-120.04474846532727,34.46748892278279,EPSG:4326,capitan,ca_m_3412040_ne_10_060_20200522,79,122,75,47,93.333336,4.582119,105,134,94,40,115.666664,4.625054,94,112,91,21,98.55556,3.9952378,159,173,159,14,164.55556,4.1852303,2020,5,143,1
284,-120.0264659128851,34.46211275710679,EPSG:4326,capitan,ca_m_3412040_ne_10_060_20200522,139,163,94,69,129.55556,4.6510844,143,151,100,51,131.88889,4.582119,121,128,96,32,117.0,4.168326,160,169,146,23,155.77777,4.211261,2020,5,143,1
285,-120.05631373002616,34.467843929740674,EPSG:4326,capitan,ca_m_3412040_ne_10_060_20200522,94,108,92,16,99.0,4.047299,108,113,105,8,108.77778,3.9952378,98,106,95,11,100.111115,3.952303,141,146,141,5,142.44444,3.5350661,2020,5,143,1
286,-120.04460214010123,34.47034100945871,EPSG:4326,capitan,ca_m_3412040_ne_10_060_20200522,88,111,68,43,84.44444,4.3491917,111,123,97,26,107.111115,3.8833375,96,109,86,23,95.0,3.857307,165,173,157,16,164.22223,3.6074753,2020,5,143,1
287,-120.0012263392654,34.45964063799308,EPSG:4326,capitan,ca_m_3412040_ne_10_060_20200522,57,59,40,19,53.88889,4.1422954,79,90,73,17,80.888885,4.090234,70,72,65,7,68.888885,3.134734,175,180,165,15,173.77777,3.7193758,2020,5,143,1
288,-120.0563371359418,34.46680608027227,EPSG:4326,capitan,ca_m_3412040_ne_10_060_20200522,121,138,119,19,126.44444,4.3491917,129,140,126,14,133.55556,4.211261,111,124,111,13,118.55556,4.280226,160,163,155,8,159.11111,3.3880088,2020,5,143,1
289,-120.02340619243266,34.46258988269456,EPSG:4326,capitan,ca_m_3412040_ne_10_060_20200522,61,123,49,74,72.111115,4.2541957,76,118,67,51,84.44444,4.323161,81,115,75,40,87.111115,4.3491917,145,157,122,35,139.88889,4.323161,2020,5,143,1
290,-120.00846923085588,34.46598915253534,EPSG:4326,capitan,ca_m_3412040_ne_10_060_20200522,109,119,109,10,114.666664,4.1422954,132,136,130,6,133.33333,3.7883413,100,108,99,9,103.44444,3.758867,183,185,180,5,182.11111,3.2577612,2020,5,143,1
291,-120.02022186274986,34.46748792067132,EPSG:4326,capitan,ca_m_3412040_ne_10_060_20200522,122,136,122,14,127.666664,4.306257,136,144,136,8,139.66667,3.8404026,121,130,120,10,123.888885,3.4435139,142,155,135,20,146.0,4.3491917,2020,5,143,1
292,-120.01950910352,34.46255974828881,EPSG:4326,capitan,ca_m_3412040_ne_10_060_20200522,70,75,59,16,68.111115,3.7193758,100,108,93,15,101.333336,3.7679935,86,87,84,3,85.666664,2.6259446,179,184,174,10,179.33333,3.9262724,2020,5,143,1
293,-120.01589058074693,34.46845843082665,EPSG:4326,capitan,ca_m_3412040_ne_10_060_20200522,113,124,69,55,106.666664,4.5560884,129,137,95,42,123.0,4.582119,120,126,87,39,114.111115,4.250752,141,154,123,31,140.33333,4.3491917,2020,5,143,1
294,-120.03662015386166,34.468368242620365,EPSG:4326,capitan,ca_m_3412040_ne_10_060_20200522,120,154,100,54,130.0,4.3491917,125,146,123,23,133.66667,4.280226,112,135,108,27,119.666664,4.1422954,160,165,150,15,158.11111,4.047299,2020,5,143,1
295,-120.04753433161808,34.46941137655804,EPSG:4326,capitan,ca_m_3412040_ne_10_060_20200522,90,108,74,34,90.111115,4.5131536,106,114,100,14,107.888885,3.9614294,103,117,91,26,103.0,4.280226,142,161,121,40,143.11111,4.625054,2020,5,143,1
297,-120.02134491494564,34.46951099619068,EPSG:4326,capitan,ca_m_3412040_ne_10_060_20200522,65,74,59,15,66.77778,4.0212684,113,117,103,14,111.44444,3.8312762,82,85,75,10,80.77778,3.857307,184,186,175,11,181.11111,4.1422954,2020,5,143,1
298,-119.99795297704053,34.46279979964329,EPSG:4326,capitan,ca_m_3412040_ne_10_060_20200522,80,100,76,24,84.0,4.418157,101,123,100,23,107.666664,3.9783335,87,91,83,8,86.55556,3.633506,148,165,143,22,150.55556,4.1852303,2020,5,143,1
299,-120.02395902366813,34.45842269278545,EPSG:4326,capitan,ca_m_3412040_ne_10_060_20200522,81,86,77,9,81.22222,3.6074753,117,121,108,13,117.111115,3.4140396,98,106,98,8,101.77778,3.495575,171,178,168,10,171.66667,3.8278327,2020,5,143,1
300,-119.81547240659152,34.42296778877044,EPSG:4326,campus_lagoon,ca_m_3411934_sw_11_060_20200521,60,61,43,18,54.11111,4.306257,81,86,64,22,78.111115,4.2541957,71,76,63,13,70.666664,3.7848978,171,183,153,30,171.11111,4.444188,2020,5,142,1
301,-119.81415857545288,34.419017293231114,EPSG:4326,campus_lagoon,ca_m_3411934_sw_11_060_20200521,111,120,108,12,113.333336,3.8278327,114,115,110,5,112.44444,3.4266095,98,99,94,5,96.111115,3.2240472,144,149,135,14,141.55556,3.7024715,2020,5,142,1
302,-119.86963911675063,34.40486037626988,EPSG:4326,campus_lagoon,ca_m_3411934_sw_11_060_20200521,28,32,25,7,28.0,3.2331736,43,47,40,7,42.666668,2.719498,53,55,51,4,52.666668,2.2783728,51,57,35,22,48.555557,4.375222,2020,5,142,1
303,-119.84067151935368,34.42178436355219,EPSG:4326,campus_lagoon,ca_m_3411934_sw_11_060_20200521,85,103,75,28,88.0,3.909368,91,96,89,7,92.55556,3.6209362,78,83,77,6,79.55556,3.22973,133,140,100,40,124.333336,4.418157,2020,5,142,1
304,-119.85668530570187,34.413460527959785,EPSG:4326,campus_lagoon,ca_m_3411934_sw_11_060_20200521,47,66,47,19,55.555557,4.116265,77,93,72,21,84.77778,4.116265,63,69,63,6,65.44444,3.6469667,160,182,154,28,169.0,4.5131536,2020,5,142,1
305,-119.81727551033958,34.41951880519455,EPSG:4326,campus_lagoon,ca_m_3411934_sw_11_060_20200521,95,101,89,12,94.111115,3.7293928,102,108,97,11,101.0,3.7419627,82,86,76,10,80.0,3.483005,150,161,149,12,154.0,3.7193758,2020,5,142,1
306,-119.86021828161364,34.40510279545925,EPSG:4326,campus_lagoon,ca_m_3411934_sw_11_060_20200521,29,31,26,5,28.666666,2.7638757,43,44,41,3,42.88889,2.3231611,51,53,51,2,51.666668,1.8359963,42,51,33,18,42.0,3.909368,2020,5,142,1
307,-119.86537257453618,34.40489014482281,EPSG:4326,campus_lagoon,ca_m_3411934_sw_11_060_20200521,28,30,26,4,27.777779,3.302139,42,45,40,5,42.444443,2.8313982,51,52,50,2,50.77778,1.796505,35,47,17,30,33.77778,4.1852303,2020,5,142,1
309,-119.8293439134514,34.424188918602205,EPSG:4326,campus_lagoon,ca_m_3411934_sw_11_060_20200521,69,84,59,25,72.666664,4.582119,85,102,76,26,89.111115,4.418157,77,85,72,13,77.44444,3.7362802,120,161,98,63,132.22223,4.5131536,2020,5,142,1
310,-119.87763086737876,34.41394816741181,EPSG:4326,campus_lagoon,ca_m_3411934_sw_11_060_20200521,85,89,55,34,74.666664,4.0212684,108,118,84,34,100.55556,4.280226,77,83,63,20,73.666664,4.0178246,177,184,153,31,172.11111,4.168326,2020,5,142,1
311,-119.845578180059,34.418663052601154,EPSG:4326,campus_lagoon,ca_m_3411934_sw_11_060_20200521,51,60,35,25,48.77778,4.3491917,77,91,50,41,74.333336,4.2541957,65,72,56,16,64.44444,4.0642033,171,187,110,77,161.66667,4.323161,2020,5,142,1
312,-119.86478026262618,34.415834733452016,EPSG:4326,campus_lagoon,ca_m_3411934_sw_11_060_20200521,61,100,60,40,75.55556,4.280226,77,114,77,37,93.0,4.1422954,69,81,69,12,74.44444,3.9783335,136,165,122,43,145.11111,4.375222,2020,5,142,1
313,-119.84982519193424,34.40515622218243,EPSG:4326,campus_lagoon,ca_m_3411934_sw_11_060_20200521,29,33,27,6,29.222221,2.4332082,43,48,41,7,43.444443,2.399258,53,56,52,4,53.22222,1.7193758,42,73,42,31,51.0,3.8404026,2020,5,142,1
314,-119.84119013688006,34.41898147539835,EPSG:4326,campus_lagoon,ca_m_3411934_sw_11_060_20200521,73,80,70,10,74.888885,3.909368,86,93,82,11,87.888885,3.505592,78,81,76,5,78.666664,3.1811123,115,140,103,37,122.77778,4.280226,2020,5,142,1
315,-119.85304008266466,34.40912685434312,EPSG:4326,campus_lagoon,ca_m_3411934_sw_11_060_20200521,84,91,70,21,81.77778,4.116265,117,119,104,15,113.44444,3.8924637,82,83,77,6,80.111115,3.5519705,198,199,194,5,196.88889,3.141621,2020,5,142,1
316,-119.8759521580266,34.404949994538825,EPSG:4326,campus_lagoon,ca_m_3411934_sw_11_060_20200521,28,31,27,4,29.0,3.3416305,44,47,42,5,44.333332,3.0297205,57,59,56,3,57.22222,3.0861163,45,46,35,11,41.88889,4.2541957,2020,5,142,1
317,-119.8711343782391,34.41595607044386,EPSG:4326,campus_lagoon,ca_m_3411934_sw_11_060_20200521,120,147,103,44,127.55556,4.5131536,127,136,106,30,126.22222,4.5560884,115,127,100,27,115.0,4.2541957,133,156,110,46,137.33333,4.375222,2020,5,142,1
318,-119.83032842345612,34.42280315503065,EPSG:4326,campus_lagoon,ca_m_3411934_sw_11_060_20200521,87,101,58,43,82.333336,4.1422954,103,117,72,45,98.888885,4.168326,86,95,73,22,85.55556,3.9262724,130,151,97,54,126.77778,4.3491917,2020,5,142,1
319,-119.87649515154423,34.4042286988007,EPSG:4326,campus_lagoon,ca_m_3411934_sw_11_060_20200521,24,27,22,5,24.666666,2.6570091,38,42,38,4,39.444443,3.1087031,50,53,49,4,50.555557,3.056642,31,53,20,33,33.333332,4.582119,2020,5,142,1
320,-119.82958221605712,34.42273930363524,EPSG:4326,campus_lagoon,ca_m_3411934_sw_11_060_20200521,64,69,57,12,62.22222,3.7848978,82,91,70,21,81.111115,4.0212684,71,74,68,6,71.888885,3.2206037,124,142,77,65,116.22222,4.323161,2020,5,142,1
321,-119.81890181633824,34.42344042245459,EPSG:4326,campus_lagoon,ca_m_3411934_sw_11_060_20200521,57,59,44,15,54.0,3.8538632,85,94,67,27,82.111115,4.418157,70,72,62,10,68.22222,3.952303,189,189,159,30,179.77777,4.306257,2020,5,142,1
322,-119.85882233465804,34.40530852321334,EPSG:4326,campus_lagoon,ca_m_3411934_sw_11_060_20200521,36,41,31,10,35.88889,3.3155997,48,52,46,6,48.555557,2.8743331,55,58,54,4,55.444443,2.1271725,65,88,50,38,64.666664,3.9228287,2020,5,142,1
323,-119.84566358990833,34.415599803551885,EPSG:4326,campus_lagoon,ca_m_3411934_sw_11_060_20200521,83,91,81,10,86.888885,3.8967981,116,122,116,6,118.77778,3.3585346,83,88,82,6,85.111115,3.6729972,186,188,182,6,185.55556,3.7848978,2020,5,142,1
324,-119.86761556230768,34.41401046719612,EPSG:4326,campus_lagoon,ca_m_3411934_sw_11_060_20200521,121,126,107,19,118.0,4.090234,109,118,101,17,107.22222,3.9783335,92,97,85,12,91.44444,3.5090356,154,158,145,13,152.66667,3.7679935,2020,5,142,1
325,-119.85790477156236,34.41630938188037,EPSG:4326,campus_lagoon,ca_m_3411934_sw_11_060_20200521,89,129,81,48,96.77778,4.418157,109,145,107,38,115.77778,4.1852303,87,129,84,45,96.888885,4.3491917,175,180,136,44,165.55556,4.280226,2020,5,142,1
326,-119.83739573424032,34.41948607977305,EPSG:4326,campus_lagoon,ca_m_3411934_sw_11_060_20200521,94,105,78,27,85.77778,3.9952378,102,107,97,10,101.111115,3.2191608,85,85,78,7,80.55556,3.176778,153,171,150,21,159.66667,3.9952378,2020,5,142,1
327,-119.81992276022632,34.42022037545083,EPSG:4326,campus_lagoon,ca_m_3411934_sw_11_060_20200521,109,114,103,11,108.111115,3.7848978,114,115,110,5,112.111115,3.728502,95,100,94,6,95.44444,3.5041492,157,163,156,7,159.44444,3.9783335,2020,5,142,1
328,-119.81064721935137,34.421353488456305,EPSG:4326,campus_lagoon,ca_m_3411934_sw_11_060_20200521,68,72,56,16,64.55556,3.410596,102,112,86,26,100.22222,4.2541957,68,70,65,5,67.22222,2.5893447,181,184,167,17,176.33333,4.1852303,2020,5,142,1
329,-119.8109366490608,34.41693879268297,EPSG:4326,campus_lagoon,ca_m_3411934_sw_11_060_20200521,117,138,84,54,113.111115,4.582119,121,141,101,40,119.55556,4.418157,112,127,95,32,110.44444,4.323161,131,164,115,49,133.33333,4.0993605,2020,5,142,1
330,-119.8782051149961,34.41870497840816,EPSG:4326,campus_lagoon,ca_m_3411934_sw_11_060_20200521,134,156,107,49,136.66667,4.2541957,126,150,124,26,136.88889,4.07333,106,121,84,37,108.55556,4.1852303,165,176,162,14,167.44444,3.952303,2020,5,142,1
331,-119.82023191878342,34.42359363136203,EPSG:4326,campus_lagoon,ca_m_3411934_sw_11_060_20200521,79,122,51,71,76.55556,4.418157,96,120,73,47,92.44444,4.5560884,87,104,66,38,80.22222,4.280226,154,172,122,50,151.33333,4.1422954,2020,5,142,1
332,-119.84710447222018,34.40805371996161,EPSG:4326,campus_lagoon,ca_m_3411934_sw_11_060_20200521,53,70,53,17,60.444443,3.676441,75,97,69,28,83.22222,4.444188,68,77,67,10,70.22222,3.194573,157,189,155,34,170.77777,4.3491917,2020,5,142,1
333,-119.843734079453,34.41007926635464,EPSG:4326,campus_lagoon,ca_m_3411934_sw_11_060_20200521,45,95,45,50,64.666664,4.5131536,58,100,58,42,74.333336,4.418157,64,90,64,26,73.55556,4.323161,64,145,64,81,101.111115,4.72005,2020,5,142,1
334,-119.85245362951116,34.415874223225075,EPSG:4326,campus_lagoon,ca_m_3411934_sw_11_060_20200521,88,102,71,31,83.77778,4.3491917,86,101,79,22,86.55556,4.2541957,79,88,74,14,80.0,3.9228287,127,139,112,27,128.33333,4.306257,2020,5,142,1
335,-119.83411668059478,34.421530887459035,EPSG:4326,campus_lagoon,ca_m_3411934_sw_11_060_20200521,145,153,111,42,134.77777,4.306257,128,135,102,33,122.888885,3.9783335,115,118,98,20,107.44444,4.0212684,164,166,139,27,157.33333,4.0303946,2020,5,142,1
336,-119.8739923304298,34.41384447395649,EPSG:4326,campus_lagoon,ca_m_3411934_sw_11_060_20200521,68,68,49,19,62.22222,4.0993605,83,85,74,11,81.888885,3.7454064,76,76,62,14,70.888885,3.2761085,133,150,113,37,133.11111,4.418157,2020,5,142,1
337,-119.84840844805755,34.41302087788777,EPSG:4326,campus_lagoon,ca_m_3411934_sw_11_060_20200521,109,122,97,25,110.333336,4.047299,133,139,130,9,134.0,4.0993605,96,102,93,9,97.55556,3.633506,191,195,187,8,191.33333,3.2626479,2020,5,142,1
338,-119.8773768318113,34.40425121771741,EPSG:4326,campus_lagoon,ca_m_3411934_sw_11_060_20200521,30,30,26,4,28.222221,2.3065956,44,44,41,3,42.22222,2.0674806,54,55,52,3,53.333332,1.8842282,53,53,44,9,50.22222,3.5216055,2020,5,142,1
339,-119.8428039077831,34.416142302014215,EPSG:4326,campus_lagoon,ca_m_3411934_sw_11_060_20200521,64,86,57,29,67.0,4.1591997,92,106,77,29,89.666664,4.1422954,74,86,67,19,74.333336,3.9353986,167,167,147,20,160.22223,3.909368,2020,5,142,1
340,-119.82997019782046,34.42243825606564,EPSG:4326,campus_lagoon,ca_m_3411934_sw_11_060_20200521,88,103,84,19,93.888885,4.07333,85,102,80,22,90.111115,4.004364,78,91,73,18,80.333336,3.9952378,121,135,113,22,123.77778,4.116265,2020,5,142,1
341,-119.83204884751262,34.420210441295474,EPSG:4326,campus_lagoon,ca_m_3411934_sw_11_060_20200521,117,121,104,17,111.77778,3.9059243,124,129,110,19,119.111115,4.250752,93,98,88,10,92.0,3.7193758,149,153,110,43,139.77777,4.418157,2020,5,142,1
342,-119.8519096746301,34.41273371382984,EPSG:4326,campus_lagoon,ca_m_3411934_sw_11_060_20200521,80,88,70,18,79.55556,4.07333,123,125,102,23,115.888885,4.1422954,84,100,76,24,87.111115,4.2971306,191,196,91,105,164.11111,4.487123,2020,5,142,1
343,-119.8601413629066,34.41146507552664,EPSG:4326,campus_lagoon,ca_m_3411934_sw_11_060_20200521,148,155,105,50,138.66667,4.5560884,138,143,109,34,132.22223,4.582119,111,121,86,35,106.0,4.3491917,177,178,172,6,175.44444,3.6595366,2020,5,142,1
344,-119.86528772518824,34.412155834866724,EPSG:4326,campus_lagoon,ca_m_3411934_sw_11_060_20200521,59,119,50,69,72.77778,4.3197174,91,114,78,36,96.22222,4.306257,64,111,61,50,73.44444,4.112821,189,192,145,47,177.77777,4.375222,2020,5,142,1
345,-119.8620007864752,34.412600621393054,EPSG:4326,campus_lagoon,ca_m_3411934_sw_11_060_20200521,80,164,54,110,103.666664,4.582119,97,158,79,79,115.44444,4.5131536,85,146,67,79,103.55556,4.5131536,161,175,152,23,162.88889,4.388683,2020,5,142,1
346,-119.82485878289816,34.41969534127895,EPSG:4326,campus_lagoon,ca_m_3411934_sw_11_060_20200521,48,60,46,14,52.333332,4.3921266,66,78,58,20,68.0,4.07333,62,68,60,8,63.444443,3.7454064,161,167,148,19,160.66667,4.323161,2020,5,142,1
347,-119.8740408085276,34.41526037331651,EPSG:4326,campus_lagoon,ca_m_3411934_sw_11_060_20200521,28,36,27,9,30.222221,3.3696618,39,49,39,10,41.88889,3.2886784,50,53,49,4,50.77778,2.7750027,33,62,33,29,44.22222,3.9783335,2020,5,142,1
349,-119.84375965141076,34.416228241844955,EPSG:4326,campus_lagoon,ca_m_3411934_sw_11_060_20200521,93,99,83,16,92.333336,3.8404026,122,129,110,19,120.55556,3.8924637,92,92,83,9,88.55556,3.4435139,192,196,186,10,192.11111,3.7454064,2020,5,142,1
350,-119.86439324750688,34.40544854393289,EPSG:4326,campus_lagoon,ca_m_3411934_sw_11_060_20200521,31,34,31,3,32.333332,2.6337225,44,49,44,5,46.11111,2.4514139,52,56,52,4,53.77778,2.5352829,63,89,57,32,71.111115,4.280226,2020,5,142,1
351,-119.86788340887536,34.40943395178478,EPSG:4326,campus_lagoon,ca_m_3411934_sw_11_060_20200521,153,156,142,14,149.0,3.8312762,134,135,119,16,128.88889,3.758867,110,113,106,7,109.333336,3.5090356,171,174,168,6,170.22223,3.0382948,2020,5,142,1
352,-119.8625075892022,34.41196136049933,EPSG:4326,campus_lagoon,ca_m_3411934_sw_11_060_20200521,124,128,69,59,108.55556,4.487123,122,129,85,44,113.44444,4.418157,110,110,83,27,102.888885,4.306257,138,151,108,43,135.77777,4.6510844,2020,5,142,1
353,-119.8413925797716,34.41493654961341,EPSG:4326,campus_lagoon,ca_m_3411934_sw_11_060_20200521,63,72,61,11,65.22222,4.280226,98,106,97,9,100.44444,4.07333,72,74,71,3,72.44444,3.069212,197,197,195,2,196.11111,3.0122643,2020,5,142,1
354,-119.81897580941607,34.41942551652757,EPSG:4326,campus_lagoon,ca_m_3411934_sw_11_060_20200521,97,99,90,9,94.55556,3.6469667,102,104,94,10,100.22222,3.857307,85,89,80,9,84.44444,3.2057002,143,152,136,16,142.88889,4.3921266,2020,5,142,1
355,-119.83444179715843,34.421301595622815,EPSG:4326,campus_lagoon,ca_m_3411934_sw_11_060_20200521,91,104,88,16,95.333336,4.3491917,93,104,87,17,95.333336,4.306257,84,89,81,8,85.666664,3.771437,116,133,115,18,125.55556,4.375222,2020,5,142,1
356,-119.84818828658489,34.41326398583603,EPSG:4326,campus_lagoon,ca_m_3411934_sw_11_060_20200521,102,112,90,22,97.77778,4.116265,127,132,120,12,125.22222,3.302139,92,96,87,9,91.0,2.896124,191,194,191,3,192.55556,2.76099,2020,5,142,1
357,-119.84134965477078,34.41983773350173,EPSG:4326,campus_lagoon,ca_m_3411934_sw_11_060_20200521,81,111,81,30,91.888885,4.2541957,98,114,95,19,102.0,3.909368,84,103,83,20,90.22222,3.952303,132,134,121,13,128.66667,4.1852303,2020,5,142,1
358,-119.82493535388348,34.42313345114375,EPSG:4326,campus_lagoon,ca_m_3411934_sw_11_060_20200521,64,78,59,19,66.0,4.2541957,87,102,77,25,89.22222,4.211261,68,73,67,6,69.666664,3.5814447,164,177,143,34,160.77777,4.444188,2020,5,142,1
360,-119.82115689447936,34.4194617323539,EPSG:4326,campus_lagoon,ca_m_3411934_sw_11_060_20200521,100,116,100,16,106.111115,3.9783335,94,104,90,14,96.666664,3.676441,81,86,79,7,82.333336,3.0768952,125,139,124,15,129.44444,4.047299,2020,5,142,1
361,-119.87227322633429,34.404798513761456,EPSG:4326,campus_lagoon,ca_m_3411934_sw_11_060_20200521,28,32,28,4,29.444445,2.6497362,42,46,42,4,44.0,2.2628644,53,54,52,2,53.11111,1.9769853,48,50,38,12,43.88889,3.7623107,2020,5,142,1
362,-119.85444020697538,34.41326418205568,EPSG:4326,campus_lagoon,ca_m_3411934_sw_11_060_20200521,138,142,132,10,138.0,3.952303,133,144,125,19,133.88889,4.0303946,113,119,110,9,113.44444,3.8798938,156,171,156,15,161.33333,4.004364,2020,5,142,1
363,-119.8533445301468,34.4155884091377,EPSG:4326,campus_lagoon,ca_m_3411934_sw_11_060_20200521,68,79,65,14,72.22222,3.8833375,84,97,80,17,86.888885,4.116265,72,77,71,6,74.666664,3.4435139,171,183,164,19,172.88889,4.280226,2020,5,142,1
364,-119.86869598771574,34.40533142256087,EPSG:4326,campus_lagoon,ca_m_3411934_sw_11_060_20200521,26,29,25,4,26.777779,2.3564177,41,42,40,2,41.0,2.0299373,50,51,50,1,50.22222,1.1496838,33,42,25,17,33.444443,4.306257,2020,5,142,1
365,-119.87101157952571,34.41465549416985,EPSG:4326,campus_lagoon,ca_m_3411934_sw_11_060_20200521,33,44,32,12,36.88889,3.4097052,45,52,45,7,47.333332,2.8608725,55,58,53,5,55.666668,2.8299553,37,51,36,15,40.77778,3.9488595,2020,5,142,1
366,-119.8153455970002,34.42307888238648,EPSG:4326,campus_lagoon,ca_m_3411934_sw_11_060_20200521,52,61,44,17,50.333332,3.9783335,85,93,74,19,80.77778,4.5131536,64,72,61,11,64.333336,3.633506,188,202,172,30,183.55556,4.444188,2020,5,142,1
367,-119.82755214470586,34.42273219877008,EPSG:4326,campus_lagoon,ca_m_3411934_sw_11_060_20200521,111,144,86,58,111.0,4.444188,113,141,92,49,113.111115,4.3491917,103,127,83,44,102.77778,4.5131536,129,142,119,23,129.11111,4.047299,2020,5,142,1
368,-119.82127306593948,34.42000532178598,EPSG:4326,campus_lagoon,ca_m_3411934_sw_11_060_20200521,111,151,101,50,121.0,4.418157,116,141,110,31,121.333336,4.168326,88,112,88,24,97.22222,4.004364,155,164,151,13,156.77777,3.5905712,2020,5,142,1
369,-119.87195911001815,34.41621793948321,EPSG:4326,campus_lagoon,ca_m_3411934_sw_11_060_20200521,99,99,79,20,89.888885,4.2541957,101,101,92,9,98.22222,3.7159321,91,95,81,14,89.0,4.090234,110,125,100,25,111.333336,4.168326,2020,5,142,1
370,-119.80995673183178,34.41905446720399,EPSG:4326,campus_lagoon,ca_m_3411934_sw_11_060_20200521,34,46,32,14,36.555557,3.8109283,50,61,49,12,53.555557,4.280226,55,59,54,5,56.22222,3.1627653,109,159,108,51,124.666664,4.582119,2020,5,142,1
371,-119.8182090274254,34.42302370875348,EPSG:4326,campus_lagoon,ca_m_3411934_sw_11_060_20200521,59,72,52,20,62.22222,4.004364,92,100,81,19,92.55556,4.112821,75,76,65,11,72.888885,3.5090356,193,200,188,12,194.0,3.8234982,2020,5,142,1
372,-119.87630481721165,34.404006018190735,EPSG:4326,campus_lagoon,ca_m_3411934_sw_11_060_20200521,28,29,26,3,27.666666,2.286656,41,43,39,4,41.0,2.396461,53,54,51,3,52.666668,2.1229854,70,82,56,26,65.666664,4.090234,2020,5,142,1
373,-119.8359961356384,34.41939957300427,EPSG:4326,campus_lagoon,ca_m_3411934_sw_11_060_20200521,129,131,111,20,122.333336,4.280226,130,130,119,11,124.111115,3.9353986,104,104,94,10,97.888885,4.1422954,165,166,157,9,161.33333,3.5476363,2020,5,142,1
374,-119.83378092959694,34.42125201639454,EPSG:4326,campus_lagoon,ca_m_3411934_sw_11_060_20200521,70,84,61,23,69.44444,4.1852303,81,93,77,16,83.55556,4.280226,75,80,70,10,74.44444,3.5780013,122,139,112,27,122.888885,4.168326,2020,5,142,1
376,-119.84092173791517,34.41587236362234,EPSG:4326,campus_lagoon,ca_m_3411934_sw_11_060_20200521,33,37,33,4,34.77778,2.8989208,47,49,47,2,48.0,2.6688795,56,58,56,2,56.88889,2.3000221,48,53,48,5,50.555557,3.3393912,2020,5,142,1
377,-119.87846250584192,34.41821755716408,EPSG:4326,campus_lagoon,ca_m_3411934_sw_11_060_20200521,130,139,116,23,128.0,4.07333,125,134,110,24,123.111115,4.211261,106,113,93,20,104.333336,4.211261,149,153,143,10,148.77777,3.7024715,2020,5,142,1
378,-119.86459519957636,34.416531366399425,EPSG:4326,campus_lagoon,ca_m_3411934_sw_11_060_20200521,53,55,41,14,48.0,3.9262724,72,72,57,15,66.22222,4.0212684,66,67,58,9,62.666668,3.345074,128,135,93,42,118.77778,4.6510844,2020,5,142,1
379,-119.83094022842444,34.422945835433254,EPSG:4326,campus_lagoon,ca_m_3411934_sw_11_060_20200521,63,70,55,15,63.22222,3.3416305,92,97,85,12,90.888885,4.116265,74,79,71,8,74.77778,3.3576438,164,177,149,28,165.0,4.444188,2020,5,142,1
380,-119.84432458428228,34.41460333709589,EPSG:4326,campus_lagoon,ca_m_3411934_sw_11_060_20200521,143,143,135,8,139.22223,3.728502,145,145,134,11,139.77777,3.7419627,137,137,124,13,130.77777,4.0867906,166,172,161,11,167.0,3.6899016,2020,5,142,1
381,-119.8531295208277,34.413294782336784,EPSG:4326,campus_lagoon,ca_m_3411934_sw_11_060_20200521,69,100,60,40,74.55556,4.487123,90,107,83,24,92.666664,4.3491917,78,107,71,36,81.111115,4.582119,187,187,140,47,171.55556,4.5560884,2020,5,142,1
382,-119.84035464313884,34.42167814741199,EPSG:4326,campus_lagoon,ca_m_3411934_sw_11_060_20200521,73,75,68,7,71.55556,2.9742157,84,90,80,10,84.22222,3.5385098,78,80,75,5,77.0,2.5935845,129,137,120,17,127.0,4.1852303,2020,5,142,1
383,-119.844090580013,34.41617186489388,EPSG:4326,campus_lagoon,ca_m_3411934_sw_11_060_20200521,68,75,67,8,70.333336,3.9952378,83,88,79,9,84.666664,3.7454064,75,84,73,11,76.44444,3.5090356,146,154,143,11,149.22223,4.323161,2020,5,142,1
384,-119.8479628492112,34.41873731788549,EPSG:4326,campus_lagoon,ca_m_3411934_sw_11_060_20200521,62,85,56,29,68.888885,4.487123,85,112,73,39,89.333336,4.582119,72,93,68,25,75.0,4.228165,177,187,143,44,169.44444,4.306257,2020,5,142,1
385,-119.87334077134778,34.41025228963056,EPSG:4326,campus_lagoon,ca_m_3411934_sw_11_060_20200521,39,89,39,50,64.333336,4.375222,51,97,51,46,76.55556,4.72005,64,87,62,25,75.22222,4.3491917,53,140,53,87,101.22222,4.6510844,2020,5,142,1
386,-119.83442256710237,34.41976599856812,EPSG:4326,campus_lagoon,ca_m_3411934_sw_11_060_20200521,90,103,77,26,90.55556,4.3491917,110,114,98,16,105.333336,4.3491917,81,86,77,9,81.22222,4.07333,167,170,144,26,156.33333,4.5560884,2020,5,142,1
387,-119.80987752278148,34.42019751097988,EPSG:4326,campus_lagoon,ca_m_3411934_sw_11_060_20200521,36,37,31,6,33.77778,3.4555316,46,54,44,10,46.333332,3.45264,56,60,53,7,55.22222,3.0297205,43,79,43,36,53.555557,4.7890153,2020,5,142,1
388,-119.87537236474256,34.41355240786117,EPSG:4326,campus_lagoon,ca_m_3411934_sw_11_060_20200521,59,64,59,5,60.555557,2.8414152,73,75,72,3,73.22222,2.419048,67,69,65,4,67.55556,2.0976982,96,107,96,11,99.111115,3.7193758,2020,5,142,1
389,-119.86965881779766,34.41135559138326,EPSG:4326,campus_lagoon,ca_m_3411934_sw_11_060_20200521,46,60,35,25,45.11111,3.9002419,64,76,51,25,60.22222,3.8664331,59,63,55,8,58.0,3.2886784,151,170,117,53,137.66667,4.116265,2020,5,142,1
390,-119.83243085284168,34.41683202762443,EPSG:4326,campus_lagoon,ca_m_3411934_sw_11_060_20200521,71,73,56,17,65.22222,3.9783335,102,104,83,21,95.0,4.444188,73,76,62,14,68.666664,3.2886784,179,188,151,37,174.88889,4.228165,2020,5,142,1
391,-119.8240596453926,34.42329431225114,EPSG:4326,campus_lagoon,ca_m_3411934_sw_11_060_20200521,82,85,62,23,78.111115,4.323161,102,102,90,12,98.888885,4.0438557,90,94,77,17,87.666664,4.375222,171,184,159,25,169.77777,4.418157,2020,5,142,1
392,-119.83706186389809,34.41945596963386,EPSG:4326,campus_lagoon,ca_m_3411934_sw_11_060_20200521,135,146,126,20,138.66667,4.211261,131,140,122,18,132.77777,4.2541957,104,111,97,14,104.888885,3.8538632,166,173,164,9,167.77777,3.0792289,2020,5,142,1
393,-119.84196356444038,34.419271784286295,EPSG:4326,campus_lagoon,ca_m_3411934_sw_11_060_20200521,91,91,75,16,82.55556,4.1422954,113,113,88,25,98.888885,3.9488595,88,88,79,9,83.77778,3.771437,156,160,130,30,143.33333,4.3491917,2020,5,142,1
394,-119.85562851886704,34.40426359532663,EPSG:4326,campus_lagoon,ca_m_3411934_sw_11_060_20200521,27,27,25,2,26.222221,2.1077328,41,42,39,3,40.77778,2.2094073,50,52,50,2,50.666668,1.786993,73,83,62,21,72.0,3.9262724,2020,5,142,1
395,-119.84406870116015,34.4137925937358,EPSG:4326,campus_lagoon,ca_m_3411934_sw_11_060_20200521,76,81,72,9,76.333336,3.728502,91,95,86,9,90.111115,3.8833375,82,82,75,7,79.111115,3.8143718,171,177,152,25,170.88889,3.8278327,2020,5,142,1
396,-119.82567169015884,34.420190369604114,EPSG:4326,campus_lagoon,ca_m_3411934_sw_11_060_20200521,30,32,30,2,30.555555,1.9582276,44,47,43,4,44.88889,2.845411,54,56,53,3,54.333332,2.027193,94,108,90,18,96.55556,4.1852303,2020,5,142,1
397,-119.86904964488056,34.4093795420621,EPSG:4326,campus_lagoon,ca_m_3411934_sw_11_060_20200521,37,48,35,13,40.555557,3.9353986,56,72,54,18,61.555557,4.116265,56,59,54,5,56.555557,3.2331736,91,132,87,45,104.888885,4.3491917,2020,5,142,1
398,-119.85010058948828,34.41461482694758,EPSG:4326,campus_lagoon,ca_m_3411934_sw_11_060_20200521,80,113,73,40,86.333336,3.7848978,122,131,107,24,122.0,4.3921266,77,106,70,36,81.0,3.909368,196,206,170,36,194.22223,3.8833375,2020,5,142,1
399,-119.82172702763008,34.421666106371056,EPSG:4326,campus_lagoon,ca_m_3411934_sw_11_060_20200521,51,69,46,23,56.11111,3.8404026,60,79,52,27,63.444443,4.0212684,66,81,61,20,68.44444,3.6074753,95,151,81,70,111.888885,4.582119,2020,5,142,1
400,-119.53260371208906,34.397173166059375,EPSG:4326,carpinteria,ca_m_3411936_se_11_060_20200521,86,96,75,21,84.22222,3.836959,94,98,85,13,92.55556,3.5385098,88,93,81,12,86.22222,3.5780013,107,130,98,32,112.77778,4.418157,2020,5,142,1
401,-119.55113611009556,34.41673098393084,EPSG:4326,carpinteria,ca_m_3411936_se_11_060_20200521,148,174,106,68,145.44444,4.280226,145,161,112,49,141.55556,3.9952378,118,138,108,30,122.666664,4.1852303,171,177,132,45,160.22223,3.8798938,2020,5,142,1
402,-119.54317698606243,34.406295118892935,EPSG:4326,carpinteria,ca_m_3411936_se_11_060_20200521,56,71,55,16,61.333332,3.7974677,70,94,70,24,80.888885,3.676441,68,74,68,6,70.77778,3.1072602,149,171,148,23,155.88889,3.952303,2020,5,142,1
403,-119.56461290750246,34.41733063261794,EPSG:4326,carpinteria,ca_m_3411936_se_11_060_20200521,107,116,107,9,111.888885,3.7623107,125,130,125,5,127.77778,3.332504,100,103,98,5,101.0,2.9727728,192,192,190,2,191.44444,1.9011325,2020,5,142,1
404,-119.50934233081192,34.395705516636774,EPSG:4326,carpinteria,ca_m_3411936_se_11_060_20200521,61,69,52,17,61.333332,4.1852303,84,99,78,21,84.888885,4.418157,66,71,63,8,65.888885,3.857307,173,192,170,22,180.11111,4.3491917,2020,5,142,1
405,-119.53461151926471,34.40143176431253,EPSG:4326,carpinteria,ca_m_3411936_se_11_060_20200521,79,86,70,16,79.0,3.909368,95,103,83,20,96.111115,3.9783335,79,81,74,7,78.888885,3.2746656,146,162,112,50,144.88889,4.323161,2020,5,142,1
406,-119.54180273944402,34.40250491145479,EPSG:4326,carpinteria,ca_m_3411936_se_11_060_20200521,98,117,82,35,98.666664,4.0212684,103,114,95,19,104.333336,3.909368,90,108,82,26,91.44444,4.116265,151,161,146,15,151.44444,4.168326,2020,5,142,1
407,-119.49785351800404,34.390077286788994,EPSG:4326,carpinteria,ca_m_3411936_se_11_060_20200521,79,99,28,71,69.888885,4.582119,116,131,44,87,101.666664,4.5131536,73,83,49,34,69.0,4.168326,193,204,91,113,173.0,4.250752,2020,5,142,1
408,-119.56209428228917,34.41778371842473,EPSG:4326,carpinteria,ca_m_3411936_se_11_060_20200521,107,117,101,16,109.0,3.7159321,125,131,122,9,126.0,2.960755,99,104,96,8,99.77778,2.9038074,189,190,187,3,188.33333,2.1114726,2020,5,142,1
409,-119.52330846530624,34.3998968052564,EPSG:4326,carpinteria,ca_m_3411936_se_11_060_20200521,135,158,95,63,118.888885,4.7890153,117,131,83,48,112.0,4.582119,89,97,77,20,84.77778,4.418157,165,193,126,67,167.33333,4.582119,2020,5,142,1
410,-119.51904651055456,34.390297016046475,EPSG:4326,carpinteria,ca_m_3411936_se_11_060_20200521,59,64,52,12,57.666668,3.5905712,78,79,68,11,74.0,3.9262724,62,65,59,6,61.11111,2.9178202,127,138,111,27,125.888885,4.306257,2020,5,142,1
411,-119.50459671446566,34.39258440039304,EPSG:4326,carpinteria,ca_m_3411936_se_11_060_20200521,112,129,80,49,108.333336,4.418157,107,128,102,26,110.55556,4.280226,90,109,74,35,92.333336,4.07333,177,195,163,32,178.33333,4.375222,2020,5,142,1
412,-119.4997959754233,34.38562374247981,EPSG:4326,carpinteria,ca_m_3411936_se_11_060_20200521,107,107,93,14,99.22222,3.8404026,101,101,92,9,97.111115,3.4661007,85,85,78,7,81.22222,3.22973,149,149,135,14,144.77777,3.6933453,2020,5,142,1
414,-119.49719666788232,34.39015020554911,EPSG:4326,carpinteria,ca_m_3411936_se_11_060_20200521,141,180,96,84,138.88889,4.5131536,156,179,127,52,153.55556,4.07333,129,171,81,90,128.44444,4.3491917,191,197,165,32,184.0,4.2372913,2020,5,142,1
415,-119.52633863661276,34.40279299160804,EPSG:4326,carpinteria,ca_m_3411936_se_11_060_20200521,60,86,43,43,58.22222,4.6510844,90,110,63,47,83.333336,4.7890153,67,82,57,25,66.22222,4.306257,185,189,131,58,162.88889,4.6510844,2020,5,142,1
416,-119.56364344629692,34.4229871540413,EPSG:4326,carpinteria,ca_m_3411936_se_11_060_20200521,111,112,105,7,108.888885,3.3585346,116,116,112,4,113.77778,2.6328318,93,94,91,3,92.22222,2.810254,165,170,164,6,166.66667,3.5075927,2020,5,142,1
417,-119.54804169779209,34.4141288758857,EPSG:4326,carpinteria,ca_m_3411936_se_11_060_20200521,61,74,61,13,67.22222,3.9353986,88,99,88,11,92.666664,4.418157,71,75,70,5,73.22222,3.2331736,184,198,184,14,192.66667,4.047299,2020,5,142,1
418,-119.52978156804105,34.39771840831307,EPSG:4326,carpinteria,ca_m_3411936_se_11_060_20200521,46,68,44,24,52.666668,4.280226,58,77,55,22,63.444443,4.1422954,62,78,58,20,65.888885,3.9353986,60,80,47,33,62.0,4.211261,2020,5,142,1
419,-119.5352493055929,34.40721164157999,EPSG:4326,carpinteria,ca_m_3411936_se_11_060_20200521,144,197,144,53,163.22223,4.5560884,158,199,157,42,173.55556,4.487123,157,193,157,36,170.0,4.418157,188,206,173,33,193.11111,4.211261,2020,5,142,1
420,-119.56295892314226,34.41788458966392,EPSG:4326,carpinteria,ca_m_3411936_se_11_060_20200521,112,113,107,6,110.888885,3.3281696,127,128,125,3,126.888885,2.98279,101,101,98,3,100.0,2.6554189,188,190,186,4,188.33333,1.9285171,2020,5,142,1
421,-119.51747257780764,34.39090279500466,EPSG:4326,carpinteria,ca_m_3411936_se_11_060_20200521,105,125,105,20,119.77778,4.07333,110,118,110,8,114.666664,3.8833375,92,102,92,10,98.888885,3.7848978,136,150,136,14,145.0,3.7193758,2020,5,142,1
422,-119.4989309562658,34.392738191906155,EPSG:4326,carpinteria,ca_m_3411936_se_11_060_20200521,32,43,32,11,36.444443,4.280226,46,67,45,22,52.77778,4.5560884,51,61,51,10,54.555557,3.9353986,59,145,53,92,91.55556,4.6510844,2020,5,142,1
423,-119.55289609513524,34.4179437228268,EPSG:4326,carpinteria,ca_m_3411936_se_11_060_20200521,114,126,83,43,109.666664,4.444188,111,122,100,22,111.333336,4.0642033,101,111,86,25,99.888885,4.090234,161,175,153,22,160.33333,4.582119,2020,5,142,1
424,-119.505257791003,34.38739974703617,EPSG:4326,carpinteria,ca_m_3411936_se_11_060_20200521,70,87,70,17,79.666664,3.909368,114,121,114,7,118.111115,3.495575,76,80,76,4,77.333336,2.8608725,193,200,192,8,195.44444,2.7616365,2020,5,142,1
428,-119.54251133951624,34.40263081221467,EPSG:4326,carpinteria,ca_m_3411936_se_11_060_20200521,88,97,82,15,89.77778,3.7848978,104,114,95,19,105.55556,3.4661007,81,86,76,10,81.666664,3.3711047,162,172,156,16,164.11111,3.8798938,2020,5,142,1
430,-119.55866095254356,34.41927820760979,EPSG:4326,carpinteria,ca_m_3411936_se_11_060_20200521,120,126,109,17,119.666664,3.771437,114,125,105,20,114.22222,4.090234,94,101,87,14,95.0,3.548527,152,160,152,8,154.66667,4.1422954,2020,5,142,1
431,-119.54213386112228,34.411504089003024,EPSG:4326,carpinteria,ca_m_3411936_se_11_060_20200521,66,97,51,46,67.77778,4.418157,82,97,65,32,80.44444,4.5131536,77,91,69,22,77.0,3.8109283,108,141,60,81,106.44444,4.6940193,2020,5,142,1
432,-119.50093949782244,34.388532102662374,EPSG:4326,carpinteria,ca_m_3411936_se_11_060_20200521,86,97,86,11,89.22222,3.591462,88,98,87,11,90.77778,3.7848978,77,85,77,8,80.333336,3.3745482,140,149,132,17,140.55556,4.1852303,2020,5,142,1
433,-119.4965208958318,34.39024514368557,EPSG:4326,carpinteria,ca_m_3411936_se_11_060_20200521,85,113,37,76,81.888885,4.5560884,95,114,49,65,80.111115,4.5131536,96,111,58,53,82.22222,4.582119,114,195,64,131,127.0,4.375222,2020,5,142,1
434,-119.55729767194757,34.42209238082723,EPSG:4326,carpinteria,ca_m_3411936_se_11_060_20200521,35,54,34,20,40.22222,4.211261,49,68,49,19,55.555557,4.444188,57,67,57,10,59.77778,3.7024715,60,140,38,102,80.44444,4.7890153,2020,5,142,1
435,-119.56566614871798,34.41890418565346,EPSG:4326,carpinteria,ca_m_3411936_se_11_060_20200521,106,109,103,6,106.55556,3.4906883,123,126,120,6,123.0,3.2761085,97,97,95,2,96.22222,2.8700933,193,196,191,5,193.55556,2.5589797,2020,5,142,1
436,-119.5249422495895,34.39715312737031,EPSG:4326,carpinteria,ca_m_3411936_se_11_060_20200521,59,91,43,48,59.666668,4.6510844,70,96,57,39,71.111115,4.6510844,65,85,59,26,65.666664,4.444188,142,167,76,91,138.0,4.5131536,2020,5,142,1
437,-119.55928222097307,34.421672211155226,EPSG:4326,carpinteria,ca_m_3411936_se_11_060_20200521,102,123,94,29,105.44444,4.280226,101,116,97,19,105.55556,4.418157,86,98,82,16,88.44444,4.211261,144,152,136,16,144.77777,4.444188,2020,5,142,1
438,-119.56318715713977,34.422580230591905,EPSG:4326,carpinteria,ca_m_3411936_se_11_060_20200521,97,102,95,7,97.111115,3.219713,109,112,105,7,108.44444,3.0557513,86,89,85,4,86.55556,2.4802413,164,167,163,4,164.55556,2.886903,2020,5,142,1
439,-119.52232882448764,34.39465398342407,EPSG:4326,carpinteria,ca_m_3411936_se_11_060_20200521,79,98,78,20,85.22222,3.857307,103,110,103,7,106.666664,3.3055828,80,86,80,6,82.0,3.2626479,179,182,173,9,178.11111,3.5949054,2020,5,142,1
440,-119.5250394314836,34.40016938527433,EPSG:4326,carpinteria,ca_m_3411936_se_11_060_20200521,113,133,96,37,111.44444,4.366096,130,137,112,25,127.55556,4.2541957,99,105,91,14,98.333336,4.1591997,194,198,171,27,190.0,3.9783335,2020,5,142,1
441,-119.55042548064722,34.41224550122126,EPSG:4326,carpinteria,ca_m_3411936_se_11_060_20200521,123,167,118,49,135.77777,4.582119,142,158,138,20,146.66667,4.3491917,148,173,144,29,154.33333,3.8538632,176,192,171,21,177.88889,4.3921266,2020,5,142,1
442,-119.56109511078353,34.42054702645974,EPSG:4326,carpinteria,ca_m_3411936_se_11_060_20200521,163,185,83,102,137.22223,4.582119,159,178,110,68,141.55556,4.168326,135,160,79,81,118.888885,4.418157,189,191,177,14,184.44444,4.211261,2020,5,142,1
443,-119.5312403634258,34.39913784560226,EPSG:4326,carpinteria,ca_m_3411936_se_11_060_20200521,82,86,76,10,81.333336,3.1473038,100,102,98,4,99.888885,2.3000221,81,83,79,4,80.666664,2.6019146,158,168,155,13,160.33333,4.07333,2020,5,142,1
444,-119.53323104584908,34.40066524383299,EPSG:4326,carpinteria,ca_m_3411936_se_11_060_20200521,88,93,86,7,88.55556,2.470557,101,105,100,5,102.0,3.0382948,83,84,81,3,82.888885,2.2658029,145,149,142,7,145.11111,3.3281696,2020,5,142,1
445,-119.50494120679669,34.39253947967636,EPSG:4326,carpinteria,ca_m_3411936_se_11_060_20200521,80,96,41,55,67.44444,4.487123,96,110,64,46,86.666664,4.6510844,67,71,55,16,63.333332,3.8538632,191,195,122,73,172.44444,4.5131536,2020,5,142,1
446,-119.54891502445084,34.413012634681635,EPSG:4326,carpinteria,ca_m_3411936_se_11_060_20200521,74,74,61,13,67.333336,3.9353986,105,110,96,14,102.44444,3.8833375,85,85,74,11,78.55556,3.559654,191,199,183,16,192.55556,4.07333,2020,5,142,1
447,-119.55838915240578,34.42256716799629,EPSG:4326,carpinteria,ca_m_3411936_se_11_060_20200521,68,68,37,31,53.666668,4.6510844,66,72,50,22,62.555557,4.1422954,71,71,60,11,66.44444,3.9002419,81,81,39,42,63.555557,4.6510844,2020,5,142,1
449,-119.5649746238818,34.41571115865238,EPSG:4326,carpinteria,ca_m_3411936_se_11_060_20200521,33,63,32,31,37.88889,3.5090356,47,75,46,29,51.22222,3.7665505,56,69,55,14,58.11111,3.1676517,37,132,33,99,54.22222,4.625054,2020,5,142,1
450,-119.53581056324688,34.402672619953265,EPSG:4326,carpinteria,ca_m_3411936_se_11_060_20200521,86,90,84,6,86.44444,2.8623154,108,109,104,5,106.44444,2.7026882,84,85,82,3,83.77778,1.6581883,167,169,161,8,164.33333,3.207143,2020,5,142,1
451,-119.5482477376748,34.41016516790647,EPSG:4326,carpinteria,ca_m_3411936_se_11_060_20200521,86,86,64,22,74.888885,4.047299,99,102,87,15,95.0,3.5124793,88,88,78,10,83.55556,3.3880088,153,185,141,44,164.77777,4.116265,2020,5,142,1
452,-119.54021361045037,34.40519919390775,EPSG:4326,carpinteria,ca_m_3411936_se_11_060_20200521,84,87,75,12,81.22222,3.5090356,104,110,97,13,104.22222,3.5554142,83,84,77,7,81.44444,2.7967935,164,175,160,15,167.11111,3.8833375,2020,5,142,1
453,-119.54292119388576,34.40517535830688,EPSG:4326,carpinteria,ca_m_3411936_se_11_060_20200521,83,88,81,7,84.44444,3.174225,96,99,94,5,96.333336,2.9312809,83,86,82,4,83.666664,2.736402,140,149,132,17,139.11111,3.857307,2020,5,142,1
454,-119.52417982149692,34.39783959602552,EPSG:4326,carpinteria,ca_m_3411936_se_11_060_20200521,106,109,94,15,101.111115,4.487123,122,125,112,13,119.666664,4.2372913,94,101,91,10,94.111115,4.1852303,195,197,176,21,190.77777,4.0178246,2020,5,142,1
456,-119.50889600187696,34.38687619824141,EPSG:4326,carpinteria,ca_m_3411936_se_11_060_20200521,56,86,51,35,65.44444,4.323161,67,96,63,33,79.0,4.418157,63,87,61,26,70.0,4.1852303,95,141,88,53,112.77778,4.5131536,2020,5,142,1
457,-119.50496393305596,34.386296898822884,EPSG:4326,carpinteria,ca_m_3411936_se_11_060_20200521,92,128,92,36,99.888885,4.211261,108,131,108,23,115.666664,4.418157,84,113,84,29,92.44444,4.3491917,188,194,176,18,187.77777,4.3491917,2020,5,142,1
458,-119.51788061344084,34.396027620571644,EPSG:4326,carpinteria,ca_m_3411936_se_11_060_20200521,67,107,37,70,69.888885,4.582119,109,132,61,71,105.44444,4.5560884,75,101,58,43,77.666664,4.116265,199,201,112,89,185.0,4.1591997,2020,5,142,1
459,-119.5057328033421,34.388888338171924,EPSG:4326,carpinteria,ca_m_3411936_se_11_060_20200521,39,51,34,17,42.22222,4.323161,55,71,52,19,58.22222,4.306257,57,62,53,9,57.77778,3.8798938,83,112,73,39,93.666664,4.5131536,2020,5,142,1
460,-119.56119382403968,34.42164298682934,EPSG:4326,carpinteria,ca_m_3411936_se_11_060_20200521,49,74,40,34,54.444443,4.280226,66,91,60,31,72.55556,4.2541957,63,74,60,14,66.55556,3.9783335,136,175,105,70,145.0,4.3197174,2020,5,142,1
461,-119.5649071687937,34.41585320831788,EPSG:4326,carpinteria,ca_m_3411936_se_11_060_20200521,60,73,56,17,63.88889,3.9783335,79,85,73,12,78.55556,4.168326,69,73,68,5,70.55556,3.4435139,164,171,155,16,162.55556,4.444188,2020,5,142,1
462,-119.5615873783534,34.423630663029414,EPSG:4326,carpinteria,ca_m_3411936_se_11_060_20200521,129,131,121,10,127.666664,3.9488595,120,122,112,10,118.0,3.857307,106,108,99,9,104.55556,3.728502,156,158,150,8,154.0,3.6040318,2020,5,142,1
463,-119.5593091466786,34.4161328177884,EPSG:4326,carpinteria,ca_m_3411936_se_11_060_20200521,102,122,94,28,109.666664,4.280226,110,122,105,17,112.55556,4.1422954,88,94,86,8,89.0,3.45264,143,160,134,26,149.66667,4.1852303,2020,5,142,1
464,-119.55820745487551,34.42195975276371,EPSG:4326,carpinteria,ca_m_3411936_se_11_060_20200521,104,120,87,33,103.666664,4.375222,105,121,90,31,106.0,3.9353986,90,99,82,17,91.0,4.004364,139,148,114,34,135.0,4.07333,2020,5,142,1
465,-119.56387111152412,34.419969562808404,EPSG:4326,carpinteria,ca_m_3411936_se_11_060_20200521,90,91,71,20,80.666664,3.909368,109,111,100,11,105.888885,3.52594,87,89,80,9,84.333336,3.1796694,190,197,186,11,192.22223,3.2726648,2020,5,142,1
466,-119.545723776501,34.41237596193338,EPSG:4326,carpinteria,ca_m_3411936_se_11_060_20200521,102,115,83,32,100.333336,4.444188,105,112,97,15,105.0,4.280226,89,96,85,11,89.77778,4.306257,140,169,137,32,150.66667,4.116265,2020,5,142,1
467,-119.54704965013512,34.41628071040228,EPSG:4326,carpinteria,ca_m_3411936_se_11_060_20200521,38,55,34,21,43.77778,3.9262724,59,77,51,26,64.888885,4.090234,61,69,58,11,63.22222,3.6990278,129,177,82,95,136.0,4.2541957,2020,5,142,1
468,-119.53363734523556,34.39769265734746,EPSG:4326,carpinteria,ca_m_3411936_se_11_060_20200521,77,82,70,12,75.22222,3.8404026,91,94,89,5,91.0,2.9673285,78,80,73,7,76.888885,3.3836746,147,159,118,41,140.77777,4.375222,2020,5,142,1
469,-119.56481536886778,34.419257399506904,EPSG:4326,carpinteria,ca_m_3411936_se_11_060_20200521,106,113,106,7,110.44444,3.9228287,124,128,124,4,126.333336,3.3190434,98,102,98,4,100.333336,3.3055828,186,188,184,4,186.11111,2.3777034,2020,5,142,1
470,-119.56066911742856,34.42284396279644,EPSG:4326,carpinteria,ca_m_3411936_se_11_060_20200521,54,55,40,15,48.77778,3.8833375,61,67,51,16,60.22222,3.8833375,63,67,58,9,63.0,3.2635386,77,82,50,32,68.333336,4.1422954,2020,5,142,1
471,-119.5230906978213,34.394384037177296,EPSG:4326,carpinteria,ca_m_3411936_se_11_060_20200521,124,137,121,16,130.0,3.8143718,121,128,121,7,124.666664,3.495575,99,105,97,8,101.0,3.0635293,159,161,156,5,158.0,3.207143,2020,5,142,1
472,-119.54562570971474,34.41193987214046,EPSG:4326,carpinteria,ca_m_3411936_se_11_060_20200521,90,101,88,13,93.22222,4.5131536,105,118,102,16,109.44444,4.211261,80,89,76,13,80.888885,3.97489,193,197,182,15,190.44444,4.323161,2020,5,142,1
473,-119.5092545835453,34.39582631770164,EPSG:4326,carpinteria,ca_m_3411936_se_11_060_20200521,73,73,49,24,63.88889,4.5131536,100,100,70,30,89.888885,4.444188,69,70,58,12,65.888885,3.9952378,199,199,170,29,188.77777,4.418157,2020,5,142,1
474,-119.55703043347862,34.42060508388789,EPSG:4326,carpinteria,ca_m_3411936_se_11_060_20200521,92,92,73,19,87.666664,3.909368,103,103,96,7,99.22222,4.090234,84,84,77,7,80.77778,3.4795613,148,160,131,29,146.33333,4.211261,2020,5,142,1
475,-119.51522597913612,34.388655571594164,EPSG:4326,carpinteria,ca_m_3411936_se_11_060_20200521,114,119,109,10,115.111115,4.2541957,110,116,108,8,112.888885,3.909368,97,108,95,13,99.55556,3.952303,138,164,130,34,139.33333,4.1852303,2020,5,142,1
476,-119.54936950858884,34.4131492008079,EPSG:4326,carpinteria,ca_m_3411936_se_11_060_20200521,129,129,118,11,124.0,3.7193758,130,130,118,12,124.333336,3.4569745,116,118,107,11,112.111115,3.5949054,146,154,128,26,143.44444,4.090234,2020,5,142,1
477,-119.56107084949932,34.420179722164654,EPSG:4326,carpinteria,ca_m_3411936_se_11_060_20200521,145,159,109,50,138.22223,4.418157,142,156,123,33,140.0,4.2541957,124,137,100,37,119.333336,4.444188,162,180,139,41,161.66667,4.1297255,2020,5,142,1
478,-119.52922281857391,34.3982330118882,EPSG:4326,carpinteria,ca_m_3411936_se_11_060_20200521,82,92,69,23,84.333336,4.0303946,93,98,90,8,94.44444,3.151638,72,82,71,11,74.55556,3.1247168,153,167,135,32,153.66667,4.1852303,2020,5,142,1
479,-119.51094175546432,34.38721284498355,EPSG:4326,carpinteria,ca_m_3411936_se_11_060_20200521,100,109,94,15,100.22222,3.5814447,101,111,97,14,103.111115,3.6040318,85,90,83,7,85.44444,3.1221638,123,132,115,17,125.22222,3.9488595,2020,5,142,1
480,-119.50007479068736,34.3934612641268,EPSG:4326,carpinteria,ca_m_3411936_se_11_060_20200521,102,115,84,31,103.666664,4.090234,98,110,98,12,104.22222,3.771437,91,99,86,13,93.666664,3.8538632,140,166,136,30,148.11111,4.5131536,2020,5,142,1
481,-119.505212304474,34.39353461072162,EPSG:4326,carpinteria,ca_m_3411936_se_11_060_20200521,30,57,27,30,39.22222,4.582119,41,73,41,32,52.77778,4.5131536,52,60,50,10,54.88889,3.6243796,92,179,88,91,119.666664,4.487123,2020,5,142,1
482,-119.52791235893716,34.40022360732733,EPSG:4326,carpinteria,ca_m_3411936_se_11_060_20200521,52,67,52,15,60.444443,4.2541957,66,84,66,18,77.111115,4.047299,61,67,61,6,64.44444,3.4661007,107,136,107,29,124.44444,4.418157,2020,5,142,1
483,-119.54952476285403,34.41159897961981,EPSG:4326,carpinteria,ca_m_3411936_se_11_060_20200521,77,86,72,14,78.77778,4.168326,94,97,82,15,90.888885,3.952303,79,82,73,9,78.0,3.6504104,181,191,156,35,178.77777,4.323161,2020,5,142,1
484,-119.55781395701902,34.42147035898088,EPSG:4326,carpinteria,ca_m_3411936_se_11_060_20200521,73,76,60,16,68.111115,4.487123,98,101,73,28,89.888885,4.487123,70,74,65,9,69.111115,3.8404026,189,194,147,47,177.66667,4.72005,2020,5,142,1
485,-119.52900718415437,34.39713943088862,EPSG:4326,carpinteria,ca_m_3411936_se_11_060_20200521,83,92,64,28,78.55556,4.2541957,102,112,78,34,98.77778,4.3491917,83,89,72,17,80.44444,4.2541957,173,178,80,98,160.66667,4.3921266,2020,5,142,1
486,-119.51706783823742,34.3930747645732,EPSG:4326,carpinteria,ca_m_3411936_se_11_060_20200521,58,74,46,28,58.555557,4.3921266,63,77,56,21,66.0,4.582119,61,67,56,11,61.77778,4.116265,97,124,84,40,102.22222,4.6510844,2020,5,142,1
487,-119.50167218819158,34.39210335893278,EPSG:4326,carpinteria,ca_m_3411936_se_11_060_20200521,54,78,37,41,55.88889,4.444188,68,92,45,47,71.0,4.3491917,57,65,50,15,57.666668,4.004364,147,173,106,67,148.33333,4.72005,2020,5,142,1
488,-119.528883827992,34.39889452168943,EPSG:4326,carpinteria,ca_m_3411936_se_11_060_20200521,89,119,82,37,92.333336,4.444188,99,114,91,23,98.333336,4.116265,86,95,79,16,84.77778,3.9783335,145,157,134,23,146.22223,4.280226,2020,5,142,1
489,-119.56526751205756,34.41910186784007,EPSG:4326,carpinteria,ca_m_3411936_se_11_060_20200521,116,127,112,15,118.55556,3.9783335,127,135,126,9,129.22223,3.5905712,104,109,99,10,103.333336,3.6040318,188,189,185,4,187.44444,2.5300577,2020,5,142,1
490,-119.55392078422942,34.415152897382654,EPSG:4326,carpinteria,ca_m_3411936_se_11_060_20200521,52,109,40,69,68.22222,4.0993605,71,105,54,51,78.333336,4.418157,70,91,64,27,75.666664,4.0212684,64,127,34,93,81.55556,4.444188,2020,5,142,1
491,-119.53817103530554,34.40412194461689,EPSG:4326,carpinteria,ca_m_3411936_se_11_060_20200521,89,93,86,7,89.22222,3.5293837,106,110,106,4,107.0,3.2626479,83,87,83,4,84.333336,2.4345095,154,160,152,8,156.55556,3.6243796,2020,5,142,1
492,-119.5438350273342,34.40475066801189,EPSG:4326,carpinteria,ca_m_3411936_se_11_060_20200521,83,89,80,9,85.22222,3.7454064,103,106,98,8,103.0,2.939855,82,85,82,3,83.55556,2.7533064,163,164,158,6,161.77777,3.633506,2020,5,142,1
494,-119.56581913487707,34.41814371369205,EPSG:4326,carpinteria,ca_m_3411936_se_11_060_20200521,85,92,82,10,85.22222,3.8538632,111,122,106,16,114.111115,3.7454064,85,87,83,4,85.22222,2.9178202,189,196,185,11,191.77777,3.4864488,2020,5,142,1
495,-119.50148748277468,34.39335123413948,EPSG:4326,carpinteria,ca_m_3411936_se_11_060_20200521,60,73,56,17,64.111115,4.375222,88,100,85,15,91.111115,4.07333,62,65,57,8,61.77778,3.2861254,192,199,190,9,194.44444,3.7193758,2020,5,142,1
496,-119.56206185971163,34.422922955859406,EPSG:4326,carpinteria,ca_m_3411936_se_11_060_20200521,127,128,89,39,112.22222,4.5131536,117,117,103,14,109.111115,4.0303946,98,99,83,16,91.666664,3.7848978,141,167,137,30,149.66667,4.5560884,2020,5,142,1
497,-119.55060791174104,34.41438367060627,EPSG:4326,carpinteria,ca_m_3411936_se_11_060_20200521,43,77,37,40,50.11111,4.5131536,57,83,52,31,65.666664,4.487123,62,71,59,12,64.55556,3.7974677,92,167,84,83,123.333336,4.7890153,2020,5,142,1
499,-119.5553225641328,34.41896400563804,EPSG:4326,carpinteria,ca_m_3411936_se_11_060_20200521,101,115,95,20,104.888885,4.1852303,100,116,97,19,105.44444,4.2541957,90,98,85,13,92.44444,3.6209362,117,149,114,35,127.22222,4.1852303,2020,5,142,1
